KEYWORD	TRANSLATION_01	TRANSLATION_02	TRANSLATION_03	TRANSLATION_04	TRANSLATION_05	TRANSLATION_06	TRANSLATION_07	TRANSLATION_08	TRANSLATION_09	TRANSLATION_10	TRADITIONAL	SIMPLIFIED	
one	eins												
two	zwei												
three	drei												
four	vier												
five	fünf												
six	sechs												
seven	sieben												
eight	acht												
nine	neun												
ten	zehn												
mouth	Mund												
day	Sonne												
month	Mond												
rice field	Feld												
eye	Auge												
ancient	Altertum	altertümlich											
recklessly	rücksichtslos	willkürlich	leichtsinnig	unverantwortlich									
I (literary)	ich (literarisch)												
companion	Freund	Begleiter											
bright	hell												
goods	Gegenstand	Sache	Produkt	Ware									
sparkling	glitzernd	Kristall											
prosperous	blühen	gedeihen	blühend	gedeihlich									
sing	singen												
early	früh												
rising sun	Strahlen der aufgehenden Sonne												
generation	Generation	Welt											
stomach	Magen												
daybreak	Tagesanbruch	Morgen											
concave	konkav	hohl	vertieft										
convex	konvex	nach außen gewölbt											
oneself	selbst	selber	persönlich										
white	weiß												
hundred	hundert												
soap	Seife												
middle (n./adj.)	Mitte												
thousand	tausend												
tongue	Zunge												
liter	Liter												
rise up	steigen	sich aufwärts bewegen											
pill	Pille	Kügelchen											
divination	Wahrsagerei	Weissagung	Vorhersage										
tell fortunes	wahrsagen												
above	oben												
below	unten												
card	Karte												
eminent	bemerkenswert	hervorragend	ausgezeichnet										
dynasty	Dynastie												
ridicule (v.)	verspotten	lächerlich machen	verhöhnen										
only	nur												
shellfish	Schalentier												
paste (v.)	kleben												
chaste	treu	keusch	Keuschheit										
employee	Mitarbeiter	Beschäftigter	Mitglied										
see	sehen												
beginning	Anfang	anfänglich											
page	Seite												
stubborn	stur												
ordinary	gewöhnlich	alltäglich	ordinär										
muscle	Muskel												
defeated	besiegt werden	verlieren	sich etw. zuziehen	etw. auf dem Rücken tragen									
uniform (adj.)	gleichmäßig	gleich											
sentence (n.)	Satz												
decameron	Dekameron	Dekade											
ladle	Kelle	Löffel	Schöpfkelle										
bull‘s eye	Ziel	Schwarze (auf der Schießscheibe)											
heads	Haupt												
straight	gerade												
set up	legen	stellen	unterbringen	installieren	einbauen								
tool	Werkzeug	Gebrauchsgerät	Gerät	Zeug									
true	wahr												
work (n.)	Arbeit	Arbeiter											
left (n./adj.)	links												
right (n./adj.)	rechts												
possess	haben												
bribe (n.)	bestechen												
tribute	Tribut												
item	Punkt												
sword	Messer	Schwert											
blade	Klinge	Schneide											
cut (v.)	schneiden	zerschneiden											
summon	rufen	zusammenrufen	einberufen										
evident	hell	klar	offensichtlich	evident	deutlich								
rule (n.)	Richtschnur	Regel	Vorschrift										
vice-	Vize-	stellvertretend											
fourth	viertens	vierte											
sting (v.)	stechen												
can (aux. v.)	können												
older brother	großer Bruder												
crest (n.)	höchster Punkt	Scheitel	Spitze										
second (adj.)	zweites												
child	Kind												
cavity	Öffnung	Loch											
roar (v.)	brüllen												
-ed	ge-												
woman	Frau												
good	gut												
be like	sein wie	wie etw. sein											
mother	Mutter												
pierce	sich durch etw. ziehen	lochen	durchbohren										
elder brother	älterer Bruder												
overcome (v.)	überwinden	sich überwinden	Gramm										
small	klein												
few	wenig												
noisy	Krach machen	zanken	Radau machen	poltern	lärmen								
large	groß												
tip (n.)	Spitze	spitz	Zinke										
evening	Abend												
many	viel												
enough	genug												
outside	außen	Außen-											
name (n.)	Name												
thick	dick	tief											
stone	Stein												
gravel	Kies												
wonderful	wunderbar	wundervoll	ausgezeichnet										
resemble	ähnlich	ähnlich sein	gleichen	ähneln									
peel (v.)	schälen												
ray	Licht	Strahl											
overly	allzu	übermäßig											
economize	sparsam sein	Provinz	sparen										
strange	sonderbar	außergewöhnlich	seltsam	merkwürdig									
stream (n.)	Fluss	Strom	Bach										
state (n.)	autonomer Bezirk	Bezirk											
obey	befolgen	folgen	entlang	in derselben Richtung	mit								
water (n.)	Wasser												
eternity	immer	ewig	fortwährend										
request (v.)	nach etw. verlangen	dringend bitten	anflehen										
spring (n.)	Quelle	Springquelle	Geysir										
flatlands	Ebene	Flachland	ursprünglich	eigentlich	original								
wish (n.)	Wunsch	Hoffnung	Begehren										
wash away	spülen	aufbrühen	etw. mit kochendem Wasser übergießen										
swim (v.)	schwimmen												
continent	Kontinent												
marsh	Teich	Sumpf	Morast										
sand (n.)	Sand												
Yangtze	Yangtse												
juice (n.)	Saft												
tide	Gezeiten	Ebbe und Flut											
source	Quelle	Ursprung	Ursprung eines Flusses										
lively	lebendig	leben											
extinguish	aufbrauchen	verbrauchen	verschwinden	zerstreuen	vertreiben								
situation	Situation	Zustand	Lage										
river	Fluss	Strom											
lake	See												
fathom (v.)	messen	schätzen	ausloten	sondieren									
soil (n.)	Erde												
equal	gleich	gleichmäßig	ausgewogen										
belly	Bauch												
fill in	füllen	auffüllen	anfüllen	ausfüllen									
spit (v.)	spucken												
waaah!	Waaa!												
Chinese inch	Chinesisches Zoll												
seal (v.)	schließen	verschließen	siegeln										
Buddhist temple	Buddhistischer Tempel												
time (n.)	Zeit												
fire (n.)	Feuer												
ashes	Asche												
vexed (adj.)	verdrossen	missmutig	verärgert										
inflammation	Entzündung	brennend heiß											
thin (adj.)	wässerig	dünn											
disaster	Katastrophe												
illuminate	scheinen	leuchten	beleuchten	fotografieren									
fish (n.)	Fisch												
fishing (n.)	fischen	Fischfang	Fischen										
Yao	Yao	Kaiser Yao											
fever	Fieber	braten	schmoren	backen									
dawn (n.)	Morgendämmerung												
li	Li												
quantity	Menge	Quantität											
bury	begraben	vergraben	zudecken	bedecken	mit Erde bedecken								
black	schwarz												
spot (n.)	Punkt	Fleck	Tropfen										
black ink	schwarzer Tuschstab	chinesische Tusche	schwarze Tusche										
risk (v.)	riskieren	emporsteigen	hochsteigen	ungeachtet (einer Gefahr)									
same	gleich												
cave	Höhle	Grotte	Loch										
orientation	Richtung	gegen	nach										
esteem (v.)	schätzen	wertschätzen	berücksichtigen	respektieren									
character	Schriftzeichen												
guard (v.)	bewachen	schützen	verteidigen										
finish (v.)	enden	beenden	fertig										
reality	Tatsache	tatsächlich	real	wirklich	Realität								
proclaim	verkünden	veröffentlichen	verbreiten	erklären	anmelden								
nighttime	Nacht												
peaceful	friedlich	ruhig	Ruhe	Sicherheit									
banquet	Festmahl	Festgelage											
mail (v.)	verschicken	versenden	abschicken	absenden	schicken								
wealthy	Reichtum	reich	wohlhabend										
store up	speichern	aufbewahren											
tree	Baum	Holz	Nutzholz										
woods	Wald	Forst	Hain	Wäldchen									
forest	Wald	Forst											
plant (v.)	pflanzen	anbauen	setzen										
apricot	Aprikose												
dim-witted	dumm	dämlich	blöde	blöd									
withered	verdorrt	ausgedorrt	welk	verwelkt									
village	Dorf	Weiler	Siedlung										
one another	einander	gegenseitig											
notebook	Wurzel	Notizbuch	Heft										
case	Rechtsfall	Akte											
not yet	noch nicht												
last (n./adj.)	letzter Teil	Ende	letzter										
foam	Schaum												
flavor (n.)	Geschmack	Aroma	kosten	schmecken									
younger sister	jüngere Schwester												
investigate	prüfen	kontrollieren	untersuchen	nachschlagen	überprüfen								
sediment	Bodensatz	Abschaum	Rückstand										
dye (v.)	färben	anstecken	abtönen										
plum	Pflaume												
table	Tisch												
as if	wie	als ob											
grass	Gras												
suffering (n.)	bitter	Bitternis	Härte	Leiden	Schmerz								
wide	breit	weit											
leaf	Blatt												
nobody	keiner	niemand	nichts	nicht									
imitate	nachahmen	imitieren	Vorbild	Norm	Standard								
desert (n.)	Wüste												
grave	Grabmal	Grab											
seedling	Spross	Trieb	Setzling	Impfstoff									
aim (v.)	zielen	anvisieren											
portent	Vorzeichen	Anzeichen	Omen										
peach	Pfirsich												
pooch	Hund												
remarkable	besonders	vornehmlich	vor allem										
silent	stillschweigend	stumm	sprachlos										
sort of thing	so, wie das da												
cry (v.)	weinen	heulen	Tränen vergießen										
utensil	Gebrauchsgegenstand	Ware	Artikel	Utensilien									
stinking (adj.)	übelriechend	stinkend											
dog	Hund												
detest	verabscheuen	ablehnen	etw. nicht leiden können										
pressure (n.)	Druck	pressen	drücken	niederhalten									
cow	Rind	Kuh											
special (adj.)	ungewöhnlich	eigenartig	speziell	sonderbar									
declare	sagen	mitteilen	informieren	bekanntgeben									
vast	sehr groß	ausgedehnt	grandios										
before	eher	zuerst	erst	voraus									
wash (v.)	waschen	reinigen											
introduce	vorstellen	jn. bekannt machen											
world	Welt	Bereich	Reich	Kreise	Gebiet								
tea	Tee												
meeting	können	Sitzung	Konferenz	Chance	Gelegenheit								
fit (v.)	passen	zusammen											
ha!	ha, ha												
pagoda	Pagode	Turm	Säule										
king	König												
jade	Jade												
ball	Ball	Kugel											
present (adj.)	gerade jetzt	jetzt	zur Zeit	gegenwärtig									
play (v.)	spielen	sich vergnügen											
crazy	irre	verrückt											
emperor	Kaiser												
resplendent	leuchtend	glänzend	brillant	großartig									
submit	einreichen	Antrag	Eingabe	Gesuch									
whole	alle	gesamt	jedes	komplett	vollständig								
logic	Vernunft	Logik											
lord	Eigentümer	Meister	Herr										
pour	gießen												
gold	Gold												
copper	Kupfer												
go fishin‘	angeln	fischen											
needle (n.)	Nadel												
nail (n.)	Nagel												
inscription	Inschrift												
at ease	ruhig	gefasst	beruhigen	Marktflecken									
way	Dao	Weg											
guide (v.)	leiten	führen											
speedy	rasch	rapid	rapide										
create	machen	bauen	erbauen	erzeugen	erfinden								
patrol (v.)	patrouillieren												
stroll (v.)	spazieren	bummeln	flanieren										
car	Wagen	Fahrzeug											
one after another	aufeinanderfolgend	eins nach dem anderen	fortwährend	verbinden									
lotus	Lotus												
in front	vor	vorne	bevor										
shears	Schere												
transport (v.)	transportieren	verlieren											
exceed	überschreiten												
each	jeder												
pattern	Muster	Norm	Standard										
guest	Gast												
forehead	Stirn	Vorderseite											
summer	Sommer												
L.A.	Luo (Fluss)	Lausanne	John Locke										
fall (v.)	fallen	sinken											
superfluous	überflüssig	überzählig	belanglos	irrelevant									
profound	tief	sinken	untergehen										
army	Armee	Heer											
radiance	Glanz	heller Schein											
carry	sich bewegen	befördern	transportieren										
crown (n.)	Krone	Kopfbedeckung	Kappe										
dream (n.)	Traum												
pit (n.)	Grube												
tall	hoch												
enjoy	genießen	Gefallen finden an											
ripe	reif	gar	zubereitet	gekocht									
pavilion	Pavillon	Laube	Kiosk										
shiny	leuchtend	leuchten	scheinen										
capital	Hauptstadt												
cool	kühl												
scenery	Landschaft	Anblick	Szenerie	Szene	Bühnenbild								
at once	plötzlich	augenblicklich	sofort										
circumference	Umfang	Umkreis	Zirkel										
week	Woche												
soldier	Soldat	Gelehrter	Intellektueller										
lucky	glückverheißend	glücklich	günstig										
buy (v.)	kaufen												
sell	verkaufen												
book (n.)	Buch												
drawing (n.)	malen	zeichnen	Malerei	Bild	Zeichnung								
scratch (v.)	ritzen	kratzen											
attack (v.)	angreifen												
fail	unterliegen	verlieren	misslingen	scheitern									
deliberately	mit Absicht	absichtlich	vorsätzlich										
rescue (v.)	retten	helfen	Beistand leisten										
revere	achten	respektieren	ehren	verehren									
spacious	geräumig	weit	weitläufig	offen									
say	sagen	sprechen	Wort										
police (n.)	Polizei	Polizist											
plan (n.)	rechnen	kalkulieren	List	Taktik	Plan								
prison	Gefängnis	Kerker	Zuchthaus										
condemn	verurteilen	tadeln	verlangen	fordern	diskutieren								
instruction	Belehrung	Unterweisung	Norm	Standard	trainieren								
talk (n.)	Rede	Worte	Sprache										
poem	Gedicht	Lyrik											
language	Sprache												
read (v.)	lesen	vorlesen	laut lesen										
tune (n.)	Melodie	Akzent	Weise										
discuss	diskutieren	sprechen	sich unterhalten	besprechen									
this	dies												
style (n.)	Typ	Stil											
test (n./v.)	experimentieren	versuchen	probieren	testen									
halberd	Hellebarde	Hiebaxt											
or	oder												
burglar	Dieb	Räuber											
laden	beladen	mit etw. beladen sein	befördern										
iron (n.)	Eisen												
lush	üppig	reichlich	prächtig										
turn into	zu etw. werden	sich zu etw. entwickeln	beenden	vollenden									
city	Stadt	Stadtmauer											
sincere	aufrichtig	ehrlich	wahr										
might (n.)	Macht	Gewalt	Ansehen										
destroy	löschen	ausmachen	vernichten										
everybody	all	alle											
reduce	reduzieren	senken	vermindern	minus	abziehen								
list (n.)	Liste												
war (n.)	Krieg												
coin (n.)	Münze	Kupfermünze	Geld										
shallow	seicht	flach	oberflächlich										
cheap	billig												
stop (v.)	stoppen	anhalten	aufhören										
footstep	Schritt												
ford (v.)	durchwaten	waten	ein Gewässer überqueren	übersetzen									
repeatedly	wiederholt	Frequenz	häufig	immer wieder									
agree	übereinstimmen	zustimmen	einwilligen										
look forward to	auf Zehenspitzen stehen	herbeisehnen	sich erhoffen										
years of age	Lebensjahr	Alter											
military (adj.)	militärisch	martialisch	kriegerisch	kämpferisch									
levy (n.)	erteilen	verleihen	Grundsteuer	besteuern									
correct (v./adj.)	aufrecht	senkrecht	berichtigen	korrigieren	korrekt								
politics	Politik												
settle on	bestimmen	festsetzen	beschließen										
walk (v.)	laufen												
transcend	übersteigen	über-	super-	übertreffen									
surpass	überschreiten	übersteigen	je mehr … desto …										
be	sein												
topic	Thema	Titel											
build	erbauen	errichten	aufbauen	bauen									
prolong	verlängern	ausdehnen	verschieben										
nativity	Geburt	Geburtstag	gebären										
clear (adj.)	klar	rein	ordentlich										
foundation	Sockel	Fundament											
clothing	Kleidung												
inside	innen	in											
grief	Trauer	Kummer											
Yuan	Yuan												
distant	fern	weit	entfernt	entlegen									
bad	schlecht	kaputt											
elementary	elementar	grundlegend	zu Beginn	anfangs									
towel	Tuch	Schal	Handtuch										
cloth	Stoff	Gewebe											
hat	Hut	Mütze											
curtain	Vorhang	Leinwand	Zelt										
cotton	Baumwolle												
help (v.)	helfen												
market (n.)	Markt												
lungs	Lunge												
sash	Band	Gürtel	Streifen	Gebiet	Zone								
stagnant	stocken	stagnieren	zähflüssig	blockieren	stauen								
thorn	Dorn	Stachel	stechen	pieksen									
system	System												
manufacture (v.)	herstellen	produzieren	erzeugen										
utter (v.)	sagen												
rain (n.)	Regen												
cloud (n.)	Wolke												
thunder (n.)	Donner												
electricity	Elektrizität												
frost (n.)	Raureif	Frost	Reif										
ice (n.)	Eis												
winter	Winter												
heavens	Himmel												
die young	jung sterben	früh sterben											
pretend	sich verkleiden	groß (gewachsen)	hoch										
bridge (n.)	Brücke												
attractive	zart	reizend	bezaubernd	weichlich	zimperlich								
standing up (adj.)	stehen												
weep	wimmern	schluchzen	weinen										
station (n.)	Haltestelle	Bahnhof	Station										
chapter	Kapitel	Abschnitt											
compete	konkurrieren	wetteifern	streiten	kämpfen									
sovereign (n.)	Kaiser	Gott											
juvenile (n.)	Knabe	Kind											
bell	Glocke	Uhr	Uhrzeit										
salesman	Handel	Kaufmann	Geschäft	Geschäftsleben									
suitable	geeignet	angemessen	brauchbar	passend									
enemy	Feind	Gegner											
ancient spoon	altertümlicher Löffel	Löffel											
north	Norden												
back (n.)	Rücken												
compare	vergleichen												
descendants	Abkomme	Abkömmling	Nachkommenschaft	Nachkömmling									
mix (v.)	mischen	vermischen	vermengen										
all	alle	jeder	allgemein	ganz									
this (literary)	dies	dieser	(literarisch od. gehobenes, Schriftsprache)										
somewhat	einige	etwas											
it	es												
purpose	Ziel	Zweck											
grease (n.)	Fett	Talg	Schmalz										
every	jeder												
small plum	Ume	Japanische Pflaume											
sea	Meer												
beg	betteln												
eat	essen												
dry (adj.)	trocken												
duplicate (v.)	doppelt	wiederholt	vervielfältigen	komplex	zusammengesetzt								
abdomen	Abdomen	Unterleib											
lack (v.)	gähnen	schulden	mangelnd	nicht genug									
blow (v.)	blasen	wehen											
song	Lied	Gesang											
soft	weich	geschmeidig	mild	sanft									
next	Mal	zweite	nächst										
assets	Kapital												
looks (n.)	Aussehen	Antlitz											
consult with	konsultieren	befragen											
compensate	kompensieren	jnd. entschädigen											
cultivate	um etw. Erde anhäufen	erziehen	ausbilden	züchten	heranbilden								
sound (n.)	Ton	Laut	Schall										
dark (adj.)	dunkel	finster	geheim	heimlich									
rhyme (n.)	Reim												
knowledge	Wissen	Kenntnis											
streamer	Fahne	Flagge	Banner										
unexpectedly	unerwartet	unvermutet											
mirror	Spiegel												
boundary	Rand	Grenze	Begrenzung										
deceased (adj.)	gestorben	selig	sterben										
blind (adj.)	blind												
absurd (adj.)	absurd	widersinnig	paradox										
expect	hoffen	erwarten											
direction	Richtung	Orientierung	Quadrat										
hinder	hindern	behindern	hemmen										
release (v.)	freilassen	loslassen	legen	stellen									
excite	branden	erregen	anreizen										
(all-purpose preposition)	Allzweckpräposition	an, als, aus, bei, in, von, zu											
side (n.)	Seite												
convert (v.)	wechseln	umtauschen											
undress	ausziehen												
speak	sprechen	sagen	erklären	erläutern									
formerly	schon einmal	früher einmal											
increase (v.)	vermehren	steigern	zunehmen										
make a present of	schenken	überreichen	Geschenke machen										
east	Osten												
building	Gebäude	First	Dachfirst										
freeze (v.)	frieren	gefrieren	einfrieren	Gelee									
also	auch												
she	sie												
ground (n.)	Boden												
pond	Teich	Weiher											
insects	Insekt	Wurm											
serpent	Schlange												
egg	Ei												
wind (n.)	Wind												
mock (v.)	spotten	verspotten	höhnen	verhöhnen	eine Satire auf etw. verfassen								
self	selbst	sich	persönlich										
alter	ändern	verändern	korrigieren	verwandeln									
remember	sich erinnern	aufschreiben	niederschreiben	sich merken									
already	schon	bereits											
wrap (v.)	einwickeln	einpacken	Paket	Beutel	Tasche								
bubbles	Blase												
begin	aufstehen	beginnen	aufbrechen										
house (n.)	Familie	Haushalt	Haus	Heim									
site	Platz												
soup	Suppe												
sheep	Schaf												
beautiful	schön												
ocean	Ozean												
fresh	frisch												
reach (v.)	erreichen	erlangen											
appearance	Aussehen	Äußere											
fall short of	Unterschied	Abweichung	nicht übereinstimmen	nicht gleichen	ermangeln	fehlen							
gather	sammeln	sich versammeln	Sammlung										
advance (v.)	vorwärtsgehen	vorrücken	hineingehen	betreten									
standard (n.)	Norm	Standard	genau	exakt	gewiss	bestimmt							
who?	wer												
vend	verkaufen	absetzen											
although	obwohl	zwar											
reliable	fest	wirklich	tatsächlich										
noon	Mittag	Jahr des Pferdes											
permit (v.)	erlauben	gestatten	genehmigen	versprechen									
feathers	Feder	Gefieder											
learn	üben	lernen	Gewohnheit										
soar	in der Luft kreisen	in der Luft schweben											
trapped	müde	matt	Schwierigkeit										
solid	fest												
country	Land	Staat	Nation										
round	Kreis	rund	kreisförmig										
cause (n.)	Grund	Ursache											
park (n.)	Park												
return (v.)	zurückkehren	sich umdrehen	beantworten										
revolve	sich winden	sich im Kreise bewegen											
picture (n.)	Bild	Zeichnung											
store (n.)	Laden	Geschäft	Gasthof	Wirtshaus	Herberge								
warehouse	Lagerhaus	Speicher	Magazin	Arsenal	Waffenlager								
trousers	Hose												
factory	Fabrik												
bed	Bett												
hemp	Hanf												
heart	Herz												
forget	vergessen												
endure	dulden	ertragen	aushalten										
recognize	wiedererkennen												
aspiration	Wille	Ideal	Ziel	Ambition									
annals	Annalen	Chronik											
consider	überlegen	denken											
idea	Bedeutung	Idee	Sinn										
think	denken	glauben	annehmen	meinen	wollen	möchten	sich nach jm./etw. sehnen	vermissen					
breath	Atem	Botschaft	Nachricht										
fear (v.)	fürchten	Angst vor etw. haben	sich ängstigen	erschrecken	einschüchtern	jm. einen Schreck einjagen							
feel (v.)	sich fühlen	merken	Gefühl	Empfindung									
regret (n.)	Bedauern	bedauern											
worried	sich Sorgen machen	besorgt sein	beunruhigt sein	Kummer	Sorge								
dread (v.)	fürchten	befürchten	Angst haben										
busy (adj.)	beschäftigt												
accustomed to	an etw. gewöhnt sein	gewöhnt	etw. aus Gewohnheit tun	etw. zu tun pflegen									
cherish	hegen	schwanger sein	Busen	Schoß	Gemüt	Sinn							
certainly	sicher	bestimmt	gewiss	unbedingt	müssen								
hand	Hand												
look at	sehen	schauen	sich etw. ansehen	blicken									
hold (v.)	nehmen	halten	abholen										
I	ich												
righteousness	Gerechtigkeit	Rechtschaffenheit											
deliberate (v.)	diskutieren	Meinungen austauschen	besprechen	durchsprechen									
ant	Ameise												
embrace	in die Arme nehmen	in den Armen halten	umarmen										
combat	Widerstand leisten	bekämpfen	verweigern	trotzen									
criticize	kritisieren	verurteilen											
beckon	winken	zu sich locken	anwerben										
strike (v.)	schlagen												
finger (n.)	Finger												
support (v.)	halten	aufrechterhalten	bewahren	wahren									
include	einschließen	umfassen											
bring up	erwähnen	etw. mit einer Hand tragen	etw. ins Gespräch bringen	etw. aufs Tapet bringen	vorlegen								
brandish	schwingen	schwenken											
push	schieben	stoßen											
welcome (v.)	empfangen	abholen											
hang	hängen	aufhängen											
press down on	pressen	drücken	unterdrücken	etw. gedrückt halten									
drop (v.)	herunterfallen	abstürzen	herabfallen	abfallen									
pull	ziehen												
!!	!!!												
look for	suchen	sich nach etw. umsehen	etw. ausfindig machen										
grind away (v.)	etw. fein mahlen	zerreiben	studieren										
play with	herumspielen	spielen											
nose	Nase												
punishment	Strafe	Bestrafung	Folter	Marter									
mold (v.)	Gussform	Typ											
genius	Genie	Talent	Begabung										
riches	Vermögen	Reichtum											
deposit (v.)	aufbewahren	deponieren	hinterlegen	aufspeichern	lagern	anlegen							
at	sich befinden	an, bei, auf, in											
only then	erst dann												
milk (n.)	Milch												
catch up with	gleichkommen	sich mit jm messen können											
inhale	einatmen	saugen											
history	Geschichte												
even more	noch mehr												
hard	hart	fest	steif										
again	wieder	noch einmal											
friend	Freund	Gefährte	Begleiter										
pair	Paar												
one of a pair	einer von zwei												
protect	schützen	beschützen	hüten	bewachen	jm. in Schutz nehmen								
seize	fangen	erbeuten	bekommen	erlangen	erringen								
observe	anschauen	beobachten											
joyous	froh	erfreut	freudig										
throw (v.)	werfen	schleudern											
not have	nicht haben	es gibt nicht											
establish (v.)	einrichten	errichten	gründen	aufstellen									
thigh	Oberschenkel												
offshoot	Abzweigung	Ableger	Zweig	Seitenlinie									
skill	Können	Fertigkeit	Kunstfertigkeit	Fähigkeit									
branch	Ast	Zweig											
uncle	Onkel												
superintend	überwachen	beaufsichtigen	kontrollieren										
lonely	still	ruhig	einsam	verlassen									
against	gegen	anti-	gegen etw. sein										
plank	Brett	Platte	Planke										
go back	zurückkommen	zurückkehren	zurück										
faction	Gruppe	Fraktion	Schule										
blood vessels	Ader	Blutgefäß	Puls	Pulsschlag									
claw (n.)	Kralle	Klaue	Pfote	Tatze									
grab	packen	ergreifen	fassen	grapschen									
pluck (v.)	Aussehen	Miene	Gesichtsausdruck										
pick (v.)	pflücken	abnehmen	zusammenlesen	auswählen	anwenden	verwenden							
vegetable	Gemüse	Gericht	Gang	Speise									
accept	entgegennehmen	annehmen	erhalten	bekommen	erleiden	ertragen	dulden	aushalten					
confer	überreichen	verleihen	geben	lehren	unterrichten	vermitteln	jm. etw. beibringen						
love (n./v.)	Liebe												
grand	männlich	grandios	gigantisch	imposant									
platform	Plattform	Terrasse	Bühne	Podest	erhöhter Platz								
govern	regieren	verwalten	regeln	regulieren	etw. in Ordnung bringen								
commence	beginnen	Anfang	am Anfang	anfangen									
go	gehen												
method	Methode												
until	bis	nach	bis zu										
room	Raum	Zimmer											
arrive	ankommen	gelangen	eintreffen										
mutual	einander	gegenseitig	wechselseitig										
sufficient	ausreichend	reichlich	voll										
education	erziehen	Erziehung	pflegen	großziehen	züchten	aufziehen							
flow (v.)	fließen	strömen	sich vom Wasser treiben lassen										
comb (n.)	Kamm	kämmen											
mountain	Berg												
exit (v.)	hinausgehen	herauskommen	verlassen										
beat (v.)	schlagen	einen Schlag versetzen	einen Stoß austeilen	zuschlagen	angreifen	überfallen							
secret (adj.)	geheim	diskret	vertraulich	intim	innig	vertraut	dicht	eng					
enter	hineingehen	eintreten	hereinkommen										
internal	innen	innerhalb											
holler (v.)	laut rufen	schreien	Kampfruf										
part (n./v.)	Teil	Bestandteil	teilen	Minute									
impoverished	arm	unbemittelt	schwatzhaft	geschwätzig									
public (adj.)	öffentlich	staatlich	gemeinschaftlich	metrisch									
pine tree	Kiefer												
valley	Tal												
bathe	baden	Bad											
desire (v.)	mögen	wollen	wünschen	begehren									
lust (n.)	Begierde	Lust	Wunsch	Verlangen	Trieb								
contain	enthalten	fassen											
dissolve	sich auflösen	sich lösen in											
work as	als … tätig sein	ebenbürtig	entsprechend	gerade als	als … fungieren								
files (n.)	Akte	Aktenschrank	Archiv										
political party	Partei	politische Partei											
often	oft	häufig											
main room	Halle	Saal	Hauptraum										
covering (n.)	Haut	Schale	Hülle	Leder									
waves	Welle												
old woman	alte Frau	Schwiegermutter	in bestimmten Berufen tätige Frau										
break (v.)	zerschlagen	beschädigen	kaputt machen										
quilt (n.)	Bettdecke	Steppdecke	Oberbett										
malicious	schlecht	übel	gemein	schurkisch	böse								
line up	aufreihen	Reihe											
intense	heftig	brennend	intensiv										
death	sterben	bis zum Tod	Tod										
inter (v.)	bestatten	beerdigen	begraben										
ear	Ohr												
take	holen	abholen	nehmen	bekommen									
interest	Interesse	Vergnügen	interessant	Vorliebe									
most (adv.)	am …sten	meist											
job	Beruf	Arbeit	Pflichten	Stelle	Amt	Posten							
holy	heilig	Heiliger	Weiser										
brave (adj.)	wagen	sich trauen	mutig	kühn	tapfer								
strict	streng	strikt											
drawn out	anmutig	entzückend	mild	lang	weit	groß	ausgedehnt						
slow (adj.)	langsam												
overflow (v.)	überfließen	überlaufen	überschwappen										
ring (n.)	Ring	Reif											
give back	noch	zurückgeben	zurückkommen	zurückkehren									
husband	Ehemann	Gatte											
regulations	Gepflogenheit	Regel	Vorschrift	Satzung	Zirkel								
replace	ersetzen	an js Stelle treten	in js Namen	um js willen									
lose	verlieren	abhanden kommen	verlorengehen										
feudal official	Beamter												
be about to	kurz vor	gerade bei											
worthy	tugendhaft	pflichtgetreu	fähig	würdig									
firm (adj.)	straff	dicht	eng										
power	Kraft	Stärke	Fähigkeit										
another	anders	anderer											
don‘t	nicht tun!	nicht …!											
turn (v.)	abbiegen	einbiegen											
male (n.)	Mann	männlich											
achievement	Verdienst	Leistung	Errungenschaft	Erfolg									
slave (n.)	Sklave	Knecht											
toil (v.)	sich anstrengen												
add	addieren	plus	zusammenzählen	hinzufügen									
congratulate	gratulieren	beglückwünschen											
shelf (n.)	Regal	Gerüst	Gestell										
cooperate	kooperieren	zusammen arbeiten	gemeinsam	mit vereinten Kräften									
line of business	Geschäftsbereich	Branche											
law	Gesetz	Regel	Statut										
recover	sich umwälzen	sich hin- und her drehen	wiederherstellen	sich rächen	Rache								
must (aux. v.)	müssen												
treat (v.)	sich aufhalten	bleiben	verweilen	behandeln	mit jm umgehen								
toward	(in Richtung) auf, nach, zu	gen	nach										
tiny	winzig												
street	Straße												
morality	Tugend	Moral	Sittlichkeit	Deutschland									
listen	hören	anhören	zuhören										
hall	Halle	großer Raum											
standing grain	auf dem Feld stehendes Getreide	Getreide											
journey (n.)	Reise	Reiseabschnitt	Reiseroute	Entfernung	Strecke								
harmony	Harmonie	Frieden	mild	mäßig	gemäßigt								
shift (v.)	versetzen	wegrücken	bewegen	verlagern	verlegen	verschieben							
autumn	Herbst												
gloomy	besorgt	beunruhigt	bekümmert	betrübt	Sorge	Kummer							
profit (n.)	Profit	Gewinn	Vorteil	Nutzen	scharf	spitz	günstig	vorteilhaft					
perfume (n.)	wohlriechend	aromatisch	duftend	Parfüm									
seasons (n.)	Jahreszeit	Saison	Ernte										
committee	jm. mit etw. beauftragen	Komitee	Kommission	betrauen									
elegant	(Getreide) Blütenstände ausbilden	in die Ähren schießen	hübsch	schön	vortrefflich	hervorragend							
penetrate	durchdringen	durch etw. dringen	durchsickern	durch und durch									
entice	verführen	verlocken	verleiten										
experience (n./v.)	durchlaufen	erleben	durchmachen										
rice	Reis												
lost	irregehen	verirren	herumirren	sich nicht orientieren können	für etw. schwärmen	Fan							
riddle	Rätsel	Mysterium	Geheimnis										
kind (n.)	Art	Sorte	Typ	Kategorie									
bamboo	Bambus												
laugh (v.)	lachen												
box (n.)	Kiste	Kasten	Koffer										
pen	Schreibzeug	Stift	Strich										
etc.	warten	und so weiter											
calculate	rechnen												
answer (v.)	antworten	entgegnen	erwidern										
strategy	Taktik	Sporn	anstacheln	anspornen									
person	Mensch	Person											
prisoner	Gefangener	Häftling	einkerkern	einsperren	ins Gefängnis stecken								
portion	Teil	Anteil	Portion										
occupy	einnehmen	ausmachen	innehaben	etw. in Besitz nehmen	erobern	sich aneignen							
furniture	Möbel	Mobiliar	Hausrat										
you	du												
you (respectful)	Sie												
what?	was												
strip (n.)	Streifen	schmaler und langer Gegenstand											
value (n.)	Wert												
make	machen	herstellen											
however	aber	doch	dennoch										
dwell	wohnen	leben											
position (n.)	Stand	Stellung	Rang										
piece	Stück												
still (adv.)	(immer) noch	noch	weiterhin	(wie vorher) bleiben	beim alten bleiben	wie sonst							
he	er												
rest (v.)	sich ausruhen	ruhen	mit etw. aufhören	etw. ruhen lassen									
faith	Vertrauen	glauben	wahr	richtig	echt	Brief							
depend on	abhängen	abhängig sein											
example	Beispiel	Exempel											
individual	Stück	individuell	jeder für sich	einzeln									
healthy	gesund	stark											
halt (v.)	stehenbleiben	stillstehen	aufhören	anhalten	innehalten								
upside down	umkehren	etw. ins Gegenteil verkehren	rückwärts	umgekehrt	verkehrt herum								
benevolence	Wohlwollen	Herzensgüte	Gutherzigkeit	Humanität									
excellent	ausgezeichnet	vorzüglich	exzellent										
wound (n.)	Wunde												
safeguard (v.)	schützen	verteidigen	etw. in Sicherheit bringen	gewährleisten	garantieren	versichern							
fort	Fort	Befestigungsanlage	Festung	Burg									
pay (v.)	zahlen	bezahlen	geben	übergeben	überlassen								
government office	Regierungssitz	Residenz											
bow one‘s head	den Kopf neigen												
substitute for	an js Stelle treten	ersetzen	geschichtliche Periode	Zeitalter	Generation								
bag (n.)	Tasche	Beutel	Sack	Tüte									
transform	verändern	umwandeln	verwandeln	zu etw. werden									
flower (n.)	Blume												
commodities	Ware	Artikel	Güter										
whatwhichwhowherewhy?	werwelchewannwowarum?												
convenient	bequem	günstig	dienlich	angenehm	nicht formell	zwanglos							
100 Chinese inches	Zhang	3 1/3 Meter	100 chinesische Zoll										
use (v.)	anwenden	verwenden	gebrauchen	einsetzen	lassen	bewirken							
long time	lange	lange Zeit											
Chinese acre	Mu	1/15 Hektar	chinesischer Morgen										
third	das dritte	der dritte der zehn Himmelsstämme											
handle (n.)	Griff	Stiel											
meat	Fleisch												
rotten	verfaulen	verderben	Bohnenkäse										
multitude	eine Menge Menschen	Massen											
sit	sitzen												
seat (n.)	Sitz	Platz											
examine	prüfen	untersuchen	sich zügeln	Selbstdisziplin haben									
face (n.)	Gesicht												
come	kommen												
wheat	Weizen	Sammelname für Weizen, Gerste, Hafer usw.											
drink (v.)	trinken												
thirsty	durstig												
appoint	ernennen	einsetzen	jn mit einem Amt betrauen	eine Funktion innehaben	eine Funktion ausüben								
royal court	Hof eines feudalen Herrschers	Regierungssitz eines Monarchen											
court of law	Gerichtshof												
by means of	mit	mittels	durch										
similar	ähnlich sein	ähneln											
combine (v.)	verschmelzen	verbinden	zusammenlegen	zusammenfassen	zusammenschließen	fusionieren	vereinigen						
piece together	zusammenstückeln	zusammensetzen											
spine	???	Lü	musikalische Note										
associate (n.)	Kamerad	Gefährte	Partner										
glory (n.)	Ruhm	Glorie	Ehre	gedeihen	florieren								
labor (n.)	Arbeit	arbeiten											
camp	Lager	Feldquartier	Baracke	Kaserne	Truppenunterkunft								
virtuous	gut	gutherzig	mildtätig										
year	Jahr												
night	Nacht												
liquid	Flüssigkeit	Saft											
call out (v.)	laut rufen	herbeirufen											
exchange (v.)	tauschen	austauschen	eintauschen	umwechseln	wechseln	tauschen							
travel (v.)	reisen												
execute	ausführen	durchführen											
go swimming	schwimmen												
tour (v.)	herumfahren	wandern	bereisen										
not	nicht	nicht …!											
suddenly	plötzlich	vernachlässigen	übersehen	ignorieren									
thing	Ding	Gegenstand											
easy	leicht												
grant (v.)	gewähren	verleihen	schenken										
corpse	Leiche	Leichnam	sterbliche Überreste										
nun	buddhistische Nonne												
woolen cloth	Wollstoff	Wollgewebe											
mud	Schlamm												
habitation	Haus	Zimmer	Raum										
grip (v.)	fassen	etw. in der Hand halten											
reside	wohnen	leben											
saw (n.)	Säge	sägen											
story	Schicht	Schichtung											
bureau	Amt	Büro	Behörde	Schachbrett	Partie	Satz							
door	Tür	Tor	Familie	Haushalt	Konto								
domicile	Haus	Zimmer	Raum										
hire (v.)	jn einstellen	jn in Dienst nehmen	mieten										
look back	sich herumdrehen und schauen	sich umsehen	auf etw. Rücksicht nehmen	berücksichtigen									
show (v.)	zeigen	etw. zur Schau tragen											
society	Gesellschaft	Vereinigung	Verein	(dem Erdgott) Opfer darbringen									
inspect	sehen	jn/etw. als … ansehen	inspizieren										
happiness	Glück	Segen	Glückseligkeit										
prohibit	verbieten	untersagen	Tabu										
front of a garment	Vorderteil eines Kleidungsstücks												
religion	Ahn	Ahnherr	Vorfahr	Sippe	Clan	Sekte	großer Meister	Vorbild	Schule				
worship (v.)	hoch	aufragend	erhaben	hochschätzen	achten	verehren							
offer sacrifice	etw. zum Opfer bringen	opfern	eine Gedenkfeier veranstalten										
scrutinize	untersuchen	etw. genau prüfen	(prüfend) in etw. Einblick nehmen										
scrub	reiben	schaben	sich schürfen	reibend streichen	abwischen	trockenwischen	streifen						
wherefore (n.)	Veranlassung	Grund	Ursache										
take out	herausziehen	herausnehmen	(einen Teil) wegnehmen										
oil	Öl												
first	der erste der zehn Himmelsstämme	das erste	das beste	erstklassig									
pawn (v.)	verpfänden	etw. als Pfand geben	unterschreiben	unterzeichnen	eskortieren								
express (v.)	erzählen	erklären	aussprechen	Tierkreiszeichen Affe									
extend	strecken	dehnen											
gods	Gott	Gottheit	Geist	Seele	Energie								
fruit	Frucht												
lesson	Unterricht	Vorlesung	Übung	Fach	Kursus	Lektion							
granule	Kügelchen	kleiner und runder Gegenstand	Körnchen	granulum	Korn								
catty (n.)	Pfund	Jin											
place (n.)	Sitz	Platz	Stelle										
near	nah												
hew	abhacken	abschlagen	abschneiden										
temporary	von kurzer Dauer	kurze Zeit	eine kleine Weile	vorläufig 	zeitweilig	vorübergehend							
gradually	allmählich	nach und nach	zunehmend										
quality (n.)	Qualität	Natur	Eigenschaft	Charakter	Wesen								
reprimand (v.)	tadeln	jn/etw. öffentlich rügen	brandmarken	vorwerfen									
accuse	mitteilen	informieren	seinem Herzen Luft machen	beschuldigen	anklagen								
for the first time	anfänglich	zu Anfang	zu Beginn	zum ersten Mal									
how?	wie	warum											
yesterday	gestern												
do	tun	machen	schreiben	verfassen	(künstlerisch) schaffen								
snow (n.)	Schnee												
anxious	es eilig haben	auf etw. brennen	ungeduldig										
seek	suchen	auf der Suche nach etw. sein	früher gebrauchtes Längenmaß, gleich acht Chi oder 2 2/3 m										
married woman	Frau	verheiratete Frau	Ehefrau										
sweep	kehren	fegen											
record (v.)	abschreiben	Protokoll führen	registrieren	einschreiben	eintragen	etw. auf Tonband aufnehmen	aufzeichnen						
commonplace (adj.)	gewöhnlich	mittelmäßig											
contend	kämpfen	ringen	wetteifern	streben	streiten								
clean (adj.)	sauber	rein											
matter	Sache	Angelegenheit											
Tang	Tang-Dynastie	Tang											
sugar	Zucker												
hale (adj.)	Gesundheit	Wohlbefinden											
overseer	Obervorsteher	Ortsvorsteher (in der alten Zeit)											
Queen Elisabeth	Queen Elisabeth	er oder sie											
monarch	Monarch	Herrscher	Gebieter										
skirt (n.)	Rock												
crowd (n.)	Menge	Gruppe	Herde	Schar									
and	und												
need (v.)	brauchen	bedürfen	etw. nötig haben										
Confucian	Konfuzianische Schule												
auspicious	Gutes verheißend	glückbringend	glücklich	glückhaft	Glück								
upright	aufrecht	richtig	etw. waagerecht halten	etw. waagerecht tragen									
bent	krumm	gekrümmt	gebeugt										
Big Dipper	der Große Bär	der Große Wagen	Dou (10 Liter)	Dou-Maß									
material (n.)	Material	Stoff											
academic discipline	Wissensgebiet	wissenschaftliche Disziplin	Lehrfach										
utilize	benutzen	anwenden	verwenden	gebrauchen									
times past	Vergangenheit	frühere Zeit											
borrow	entleihen	leihen	borgen										
mistaken	Fehler	Irrtum	falsch	irrtümlich	versehentlich								
scattered	verstreut	auseinander	sich lösen	sich lockern	auseinandergehen	lose							
scatter	streuen	ausstreuen	spritzen	verstreuen	zerstreuen	verschütten							
prepare	vorbereiten	bereiten	bereithalten	Vorkehrungen treffen									
twenty	zwanzig												
mat	Matte	Strohmatte	Sitz	Platz									
degrees	Grad												
ferry (n./v.)	übersetzen	überqueren	Fährstelle	Übergang									
half (n./adj.)	Hälfte	halb											
partner	Gefährte	Partner	Begleiter	Gesellschafter									
fat (adj.)	dick	beleibt	korpulent	dickleibig									
judge (v.)	unterscheiden	auseinanderhalten	beurteilen	entscheiden	verurteilen	ein Urteil fällen							
dependents	Familienangehörige(r)												
boxing (n.)	Faust	Boxen	Faustkampf										
victory	Sieg	die Oberhand gewinnen											
slice (n.)	Scheibe	Platte	kleines, flaches Stück										
printing plate	Druckplatte	Druckstock	Klischee	Matrize	Auflage	Ausgabe							
put on makeup	Make-up auflegen	sich schminken											
robust	stark	kräftig	verstärken	kräftigen									
hamlet	Dorf	Gut	Gehöft	Dörfchen									
attire (n.)	schmücken	sich verkleiden	Kleidung	Tracht									
General	General												
of	von												
weary	mangeln	müde	matt	erschöpft	abgespannt	abgenutzt	verbraucht						
blink (v.)	zwinkern	blinzeln											
no	nein	nicht											
negate	verneinen	nein sagen	nein										
cup	Becher	Tasse	Glas	Pokal									
dart (n.)	Pfeil												
tribe	Stamm	Sippschaft	Clan	Todesstrafe im alten China									
know	wissen	kennen	Bescheid wissen	Wissen	Kenntnis								
wisdom	Weisheit	Klugheit	weise	klug									
spear (n.)	Speer	Lanze											
gentle	weich	biegsam	geschmeidig	sanft	sanftmütig	lind							
knead	reiben	kneten											
tasks	Angelegenheit	Geschäfte											
fog	Nebel	Dunst											
bestow	geben	gewähren	jm etw. zukommen lassen	verleihen									
preface (n.)	Reihenfolge	Ordnung	Einleitung	Vorwort									
beforehand	vorher	im voraus											
wild (adj.)	wild	unkultiviert	ungezähmt	offenes Land	nicht an der Macht sein								
class (n.)	Klasse	Schulklasse	Team	Gruppe									
bow (n.)	Bogen												
draw (v.)	ziehen	anspannen											
strong	stark	kräftig											
weak	schwach												
bullet	Kugel	Kügelchen	Geschoss	Bombe									
Buddha	Buddha	Buddhismus											
expense	Gebühr	Kosten											
younger brother	jüngerer Bruder												
No.	Ordnungszahl												
adroit	geschickt	gewandt											
somebody	Rumpf	Körper	selbst	persönlich									
shoot (v.)	schießen	feuern											
thank	danken	sich bedanken											
old man	alt	betagt	Alte(r)	älterer Herr									
take an exam	eine Prüfung abhalten	eine Prüfung ablegen											
roast (v.)	backen	rösten	grillen										
filial piety	Kindespflicht	Pietät											
teach	lehren	unterrichten	beibringen	erziehen									
someone	jemand	jemand mit einer Eigenschaft	derjenige mit einer Eigenschaft										
-ing	gerade …	-nd											
pig	Schwein												
chase	verfolgen	nacheilen	jm nachsetzen	hinter jm her sein									
commander	Oberbefehlshaber	Oberkommandierender											
teacher	Lehrer	Meister											
lion	Löwe												
bureaucrat	Beamter	Staatsangestellter											
pipe	Rohr	Röhre	Leitung										
father	Vater												
mingle	mit jm Bekanntschaft schließen	mit jm Umgang pflegen											
effect (n.)	Effekt	Wirkung											
relatively	vergleichsweise	relativ	verhältnismäßig										
school (n.)	Schule												
lower leg	Fuß	Bein	genügend	genug	ausreichend								
run (v.)	laufen	rennen											
jump (v.)	springen	hüpfen											
path	Weg	Straße	Pfad										
dew	Tau	Saft	Sirup										
skeleton	Knochen	Gerüst	Gestell	Gerippe	Rückgrat	Wesensart	Charakter						
slippery	glatt	rutschig	schlüpfrig	gleiten	rutschen								
cross (v.)	hinübergehen	überschreiten	überqueren	passieren									
Apollo	Alpen												
aah!	Ah!												
occasion	Gelegenheit	aus Anlass	anlässlich	Grenze	Rand								
perilous	Gefahr	Risiko	schwer passierbare Stelle	enger Pass	Barriere								
as you wish	nach Belieben	beiläufig	nebenbei	folgen	sich fügen								
Yang	Yang												
exhibit (v.)	ausstellen	etw. zur Schau stellen											
ward off	verteidigen	schützen	sich in acht nehmen	Vorkehrungen treffen	vorbeugen	Damm	Deich						
attach	beifügen	beilegen											
Inst.	Hof	umzäuntes Grundstück	Regierungsinstitution	Institution	Anstalt	Anstalt des öffentlichen Lebens							
battle formation	Schlachtordnung	Front											
team	in Reih und Glied	Gruppe	Mannschaft	Team									
descend	fallen	sinken	senken	etw. sinken lassen									
stairs	Stufe	Treppenstufe											
hole	Höhle	Nest	Loch	Akupunkturpunkt									
research (v.)	erforschen	untersuchen	einer Sache auf den Grund gehen										
abruptly	plötzlich	vorspringend	Kamin	stürmen	vorstürmen								
empty	leer	hohl											
control (v.)	beherrschen	dominieren	herrschen										
border	Seite	Grenze	Grenzgebiet										
deep	tief												
spy (n.)	Detektiv	Kundschafter	Späher	auskundschaften	sondieren	etw. vorsichtig erkunden							
hill	Erdhügel	Hügelchen											
troops	Waffe	Kampfgerät	Soldat	Armee	Truppe								
silk	Seide												
line (n.)	Linie	Faden	Garn	Zwirn	Draht	Faser							
maintain	wahren	bewahren	aufrechterhalten	binden	zusammenhalten								
silk gauze	Vogelnetz	Fangnetz	mit einem Netz Vögel fangen	sieben (V.)	feines Sieb	dünner gazeartiger Seidenstoff							
continue	fortsetzen	fortfahren	weiterführen										
continuum	komplexes System	Zusammenhang											
give	geben	gewähren											
tie (v.)	knüpfen	knoten	schlingen	binden	Knoten								
end (n.)	Ende	Schluss											
rank (n.)	Rang	Ebene	Stufe	Grad	Klasse	Treppenstufe							
epoch	Zeitalter	Epoche	Periode										
red	rot												
make an appointment	sich verabreden	vereinbaren	abmachen	eine Verabredung treffen	Vereinbarung	Übereinkunft	Verabredung						
fine (adj.)	dünn	schmal	fein	winzig									
tight	straff	fest	dicht	hart									
weave (v.)	weben	flechten	stricken										
net (n.)	Netz												
green	grün												
curved (adj.)	krumm	gekrümmt	gebogen	gewunden									
bay (n.)	Flussbiegung	Flusskrümmung	Bucht	Meerbusen	Golf								
be enamored of	lieben	sich verlieben											
change (v.)	sich verändern	sich wandeln	ändern	verändern	umwandeln	zu etw. werden							
scripture	heilige Schrift	Kanon	kanonische Bücher	klassische Werke	Kette	Längsfaden	Kettenfaden	geografische Länge					
lightweight (adj.)	leicht												
behind	hinten	hinter	nach	danach	später								
how many?	wie viele												
machine	Maschine	mechanisches Werkzeug	Apparat	Gerät									
sever	abbrechen	abschneiden	brechen	zerbrechen	knicken								
carry on	fortsetzen	nachfolgen											
obvious	sichtbar	deutlich	offensichtlich										
music	Musik												
medicine	Medizin	Arznei	Medikament										
chicken	Huhn												
(suffix)	Suffix	Fragepartikel											
lineage	System	Fachbereich	Abteilung	Fakultät									
relate to	um etw. gehen	sich um etw. handeln	mit etw. zu tun haben	betreffen									
grandchild	Enkel												
withdraw	sich zurückziehen	rückwärts gehen											
foot	Fuß												
apparel	Kleidung	Kleid	Anzug	(Medizin) einnehmen	etw. auf sich nehmen	übernehmen							
fate	Leben	Schicksal	Los	Geschick									
stay (v.)	bleiben	verweilen	sich aufhalten										
slide (v.)	gleiten	rutschen	glatt										
chat (v.)	plaudern	sich unterhalten											
willow	Weide												
orders (n.)	Befehl	Erlass	Anordnung	Order									
cold	kalt												
zero	null	Null											
collar (n.)	Kragen	Hals											
communicate	verbinden	mit jm verkehren	in Verbindung stehen	benachrichtigen	informieren	bekanntgeben	jn von etw. in Kenntnis setzen						
courageous	mutig	kühn	tapfer	beherzt	verwegen								
criminal (n.)	gegen etw. verstoßen	übertreten	Verbrecher	begehen	verüben								
danger	Gefahr												
fragile	zerbrechlich	brüchig	spröde	knusprig	bröckelig								
print (n./v.)	drucken	kopieren	Abdruck	Siegel	Stempel								
excitement	Lust	Interesse	Freude										
liquor	alkoholische Getränke	Spirituosen											
distribute	zusammenmischen	zusammenstellen	paaren	eine Ehe schließen									
chieftain	Stammeshäuptling	Anführer	Chef	Häuptling									
venerate (v.)	ehren	hochachten	respektieren	älter	ranghöher	dienstälter							
abide by	folgen	befolgen	einhalten										
beans	Bohne												
head (n.)	Kopf												
short	kurz												
ceremony	Ritual	Zeremonie	Zeremoniell	Feier	Geschenk	Höflichkeit	Etikette						
body	Körper	Körperteil	Stoff	Substanz	Stil	Typ							
drum	Trommel												
joyful	Freude	sich freuen	glückliches Ereignis	fröhliche Feier	Freudentag	Schwangerschaft							
kitchen	Küche												
timber	Baum	pflanzen	anbauen										
blood	Blut												
exhausted	zu Ende	erschöpft	am Ende	nicht mehr weiter	äußerst								
to the utmost	möglichst	mit allen Mitteln	mit aller Kraft	ganz	äußerst	höchstens	innerhalb von						
lid	Deckel												
temperature	lauwarm	warm	Temperatur										
supervise	überwachen	beaufsichtigen	kontrollieren	Gefängnis	Haftanstalt								
basket	Korb												
blue	blau												
silver	Silber												
heel (n./v.)	Ferse	folgen											
very	sehr												
root (n.)	Wurzel												
immediately	sobald als	unmittelbar nachdem	unverzüglich	prompt	sofort	unmittelbar	sogleich	selbst	selbst wenn				
holiday	Fest	Feiertag	Gelenk	Glied	Knoten								
retreat (v.)	sich nach rückwärts bewegen	sich zurückziehen	zurückbewegen	zurückziehen	zurücktreten	abtreten	(Dienst usw.) quittieren						
leg	Bein												
limit (n./v.)	Grenze	Limit	Schranke	ein Limit setzen	beschränken	begrenzen	einschränken						
eyelet	Auge	Blick	kleines Loch	enge Öffnung									
high-quality (adj.)	gut	fein	gute Leute	von guter Qualität									
breakers	Welle	Woge	Brecher										
mom	Mutter	Frau	Tante	junge Frau									
food	essen	Mahlzeit	Essen	Essbare	Genießbare	Nahrungsmittel							
meal	Mahlzeit	tischfertig zubereitete Speisen	Nahrung	Essen									
dine	essen	speisen	eine Mahlzeit einnehmen	Nahrung zu sich nehmen									
Bldg.	Unterkunft für Gäste	Laden	Geschäft	Stätte für kulturelle Aktivitäten									
raise (v.)	ernähren	züchten	großziehen										
since	schon	bereits	wenn …, dann …	da									
approximate (adj.)	allgemein	im allgemeinen	ohne Ausnahme	ausnahmslos	kategorisch	überhaupt							
even (adj.)	eben	platt	flach										
evaluate	kommentieren	kritisieren	Kommentar	beurteilen	abschätzen								
level ground	ebene Fläche												
ooh!	Oh!												
shout (v.)	ausatmen	herausschreien	rufen	puffen	nennen	aufrufen							
hope (v.)	hoffen	wünschen	erwarten										
scarce	selten	wenig	rar	dünn	spärlich	licht							
study (v.)	lernen	studieren											
senses (n.)	empfinden	fühlen	spüren										
stir (v.)	umrühren	mischen	stören	belästigen									
sinister	unheildrohend	verhängnisvoll	unheilvoll	schlechte Ernte									
cruel	böse	furchterregend	Gewalttat	Mordtat									
bosom	Brust	Busen											
leave (v.)	verlassen	trennen	sich entfernen										
fowl	Vögel												
peppery	scharf	beißend	hart	mühsam	Leiden								
manage	handeln	erledigen	besorgen	veranstalten	verwalten								
dispute (v.)	erörtern	disputieren	debattieren										
partition (n.)	Wand	Mauer											
evade	ausweichen	vermeiden	meiden										
new	neu												
fuel	Brennholz	Reisig											
relatives	Elternteil	Blutsverwandter	Verwandter										
inner garments	füttern	Futterstoff einnähen	Futterstoff										
good fortune	sich gratulieren können	zum Glück	glücklicherweise	Glück									
clench (v.)	halten	packen	etw. in der Hand haben	innehaben	ausüben								
newspaper	Zeitung	mitteilen	Bericht erstatten	benachrichtigen									
call (v.)	rufen	ausrufen	schreien	heißen	bedeuten	nennen	anreden						
receive	entgegennehmen	aufnehmen	annehmen	empfangen									
land (n.)	Festland												
force (n.)	Macht	Einfluss	Stärke	Wucht	Trend	Tendenz							
heat (n./v.)	Wärme	heiß	warm										
technique	Geschicklichkeit	Kunstfertigkeit	Kunst										
sign of the pig	Tierkreiszeichen Schwein												
nucleus	Kern	Stein											
tot	Kind												
carve	schnitzen	Viertelstunde	Moment										
should	sollen	müssen											
narrate	schildern	erzählen	darlegen	berichten									
art	Können	Kunst	Technik										
kill	töten												
aid (v.)	helfen	assistieren											
yield	lassen	nachgeben	jm einen Vorteil überlassen	jm den Vortritt lassen	zulassen	jm etw. überlassen	jm etw. abtreten	erlauben					
territory	Erdreich	Boden	Gebiet										
frigid	kalt												
competition	Wettkampf												
poison (n.)	Gift												
vegetarian diet	pflanzliche Nahrungsmittel												
blue or green	blau	grün	grün-blau										
refined	raffiniert	verfeinert	erlesen	ausgesucht	Extrakt	Essenz							
invite	bitten	ersuchen	engagieren	einladen									
feelings	Gefühl	Gemütsbewegung	Gefühlsregung	Sexualtrieb									
eyeball	Augapfel												
pure	klar	sauber	durchsichtig	rein									
quiet	still	ruhig	friedlich	geräuschlos									
responsibility	Pflicht	Verantwortung											
accomplishments	Verdienst	Tat	Leistung	Hanfgarn zwirnen									
accumulate	aufhäufen	anhäufen	ansammeln										
surface (n.)	Oberfläche	Außenseite											
watch (n.)	Uhr	am Körper getragene Uhr	Armbanduhr										
life	gebären	Leben	Existenz										
star (n.)	Stern												
surname	Familienname	Sippenname											
sex	Geschlecht												
harm (n./v.)	schädlich	schädigen	Schaden										
cut off (v.)	schneiden	mähen											
intelligent	klug	weise	intelligent	scharfsinnig									
plentiful	reichlich	üppig	im Überfluss										
springtime	Frühling												
tranquil	heil	friedlich	Thailand										
proffer (v.)	etw. höflich überreichen	etw. mit Ehrerbietung schenken	jm etw. mit höflicher Zurückhaltung anbieten										
cudgel (n.)	Stock	Stange	Knüppel	Keule									
diligent	fleißig	arbeitsam	emsig	unermüdlich									
careful	behutsam	vorsichtig	sorgfältig										
merely	nur	bloß	erst										
Han	Han	Han-Nationalität	Han-Dynastie										
difficult	schwer	schwierig											
vendor‘s stand	ausbreiten	auslegen	offener Verkaufsstand	Stand	Verkaufsstand	einen Anteil tragen							
splendor	prächtig	prunkvoll	luxuriös	extravagant	China								
clamor (n.)	Lärm	Geräusch	Getöse										
droop	herabhängen	nach unten hängen											
hammer (n.)	Hammer												
sleep (v.)	schlafen												
now	Gegenwart	gegenwärtig	heute	jetzt	 nun								
harbor (v.)	etw. im Mund haben	enthalten	hegen	zurückhalten									
miss (v.)	an jn/etw. denken	gedenken	vermissen	Gedanke	vorlesen								
Yin	Yin												
shady	schattig	feucht und kühl											
west	Westen												
want (v.)	wollen	etw. haben (bzw. tun) wollen	nach etw. verlangen										
waist	Taille	Hüfte											
ticket	Karte	Zettel	Wahlzettel										
drift (v.)	(im Wasser) treiben	treiben	dahintreiben	von der Strömung getragen werden									
mark (n.)	Marke	Kennzeichen	Merkmal										
merchant	Kaufmann												
price	Preis	Wert											
smoke (n.)	Rauch	in die Augen beißen											
south	Süden												
gate	Tor	Tür	Eingang										
(plural)	Plural	(Plural)											
leisure	unbeschäftigt	müßig	frei haben										
ask	fragen	befragen	sich nach etw. erkundigen										
interval	Zwischenraum	Lücke	Zwischenzeit										
simple	einfach	unkompliziert											
open (v.)	öffnen												
hear	hören	Neuigkeit	Nachricht	riechen									
storehouse	Aufbewahrungsort	Stapelplatz	Kornkammer	Kornspeicher	Speicher	Magazin	Lager	Vorratshaus					
gun	Gewehr	Büchse	Feuerwaffe										
initiate (v.)	(erstmals) erzielen	erzielen	erreichen	etw. zustande bringen									
non-	nicht entsprechen	nicht in Einklang stehen	nicht										
row (n.)	reihen	ordnen	Reihe										
guilt	Verbrechen	Sünde	Schuld										
lean on	an … lehnen	sich anlehnen	sich auf … stützen										
marquis	Fürst	zweithöchster Adelsrang unter den fünf Rängen in alter Zeit											
wait (v.)	warten	abwarten	erwarten	Zeit									
decide	entscheiden	beschließen	bestimmen	hinrichten									
fast (adj.)	schnell	rasch											
chopsticks	Essstäbchen												
tanned hide	Leder												
surround	umgeben	einschließen	umkreisen	umzäunen	rings	ringsherum	rundum						
great	groß	bedeutend											
defend	verteidigen	beschützen	sichern	bewahren									
offend (v.)	jn verletzen	jn vor den Kopf stoßen	jm zu nahe treten	Schild									
shore	Ufer	Küste											
trunk	Hauptteil	Stamm	Rumpf	Rückgrat	tun	machen							
drought	Trockenheit	Dürre											
hurry (v.)	einholen	aufholen	etw. zu erreichen versuchen	sich beeilen, um etw. nicht zu versäumen	sich beeilen								
Yu	Yu												
eaves	Dachtraufe	Dachrinne	Weltraum	Universum	Kosmos								
moi	ich												
excess	übrig	überflüssig	verbleibend	restlich	überschüssig								
eliminate	loswerden	entfernen	ausmerzen	beseitigen									
route (n.)	Weg	Strecke											
bundle up	binden	schnüren	Bündel	binden	beherrschen	zügeln	einschränken						
quick	schnell	geschwind	rasch	Tempo	Geschwindigkeit								
spicy hot	beißend	scharf											
entire	ganz	gesamt	vollkommen	vollständig	ordentlich	geordnet	akkurat	sauber	reinlich	gepflegt			
practice (v.)	üben	trainieren	weiße Seide	Rohseide kochen									
opt for	auswählen	aussuchen	auslesen										
heavy	Gewicht	schwer	gewichtig	hoch	wichtig								
understand	verstehen	begreifen	kapieren	Bescheid wissen									
move (v.)	sich bewegen	sich rühren											
species	Art	Spezies	Sorte	Rasse	Typ								
collide	Krach	Zusammenstoß	Kollision	Verkehrsader	Hauptverkehrsstraße								
illness	krank sein	erkranken	Krankheit	Beschwerde									
ache (v.)	Schmerz	Weh	Leiden										
insane	geisteskrank	verrückt	irrsinnig										
match (v.)	ebenbürtig sein	sich mit jm messen können											
region	Region	Zone	Gebiet	Bezirk	Distrikt								
hub	Türangel	Zentrum	Zentrale	Knotenpunkt									
Europe	Europa												
physician	Arzt	Doktor	Medizin	Gesundheitswesen									
look up to	das Gesicht nach oben richten	zu jm aufschauen	respektieren	bewundern									
greet	entgegenkommen	abholen	empfangen	begrüßen									
ascend	in die Höhe gehen	nach oben steigen	besteigen	ersteigen									
lamp	Leuchte	Lampe	Laterne										
evidence	nachweisen	beweisen	belegen	Beweis	Zeugenaussage	Zeugnis	Ausweis	Bescheinigung	Schein	Zertifikat			
send out	senden	absenden	aufgeben	schießen	abfeuern	ausstrahlen							
discard (v.)	aufgeben	fallenlassen	abschaffen	etw. ungültig machen									
shape (n.)	Form	Gestalt											
shadow (n.)	Schatten												
hue	Farbe	Buntheit	Farbigkeit	Färbung	vielfarbig	farbig							
have to	müssen	etw. zu tun haben											
rare	Schatz	Kostbarkeit	kostbar	wertvoll	selten								
participate	an etw. teilnehmen	an etw. teilhaben	sich an etw. beteiligen	mitmachen									
wretched	traurig	tragisch	bejammernswert	jämmerlich	entsetzlich	schauerlich							
repair (v.)	schmücken	verzieren	dekorieren	reparieren	restaurieren	ausbessern							
literature	Schrift	Schriftzeichen	literarisches Schaffen	Aufsatz	Artikel	Text	Kultur						
mosquito	Mücke												
erudite	intelligenter und ehrenhafter Mensch												
countenance (n.)	Gesicht	Gesichtsausdruck	Ansehen	Prestige	Reputation								
products	gebären	zur Welt bringen	entbunden werden	Produkt	Ertrag	Erzeugnis	produzieren	erzeugen	herstellen				
rate (n.)	Proportion	Rate	Quote										
tumble (v.)	auf den Boden fallen	stürzen	abstürzen										
center	Zentrum												
England	England	Held	Blüte	Blume									
crust	etwas Eingetrocknetes	Kruste	an etw. haften	jn/etw. anhaften									
grasp (v.)	halten	greifen	ergreifen	Griff	Kurbel	Handgriff	Henkel						
papa	Papa												
bar (n.)	Bar	emphatischer Finalpartikel											
color (n.)	Farbe												
discontinue	abbrechen	abschneiden	unterbrechen										
sweet	gefällig	wohltuend	süß										
such and such (adj.)	gewiss	bestimmt											
his-hers-its-theirs	sein	ihr											
period of time	Periode	Zeitraum	Phase										
base (n.)	Grundlage	Basis	Fundament										
Sphinx	dies	so	dann	Sphinx									
tremendously	sehr	äußerst	mehr als										
expensive	von hohem Preis	teuer	kostspielig										
bequeath	verlieren	verlorengehen	abhanden kommen	zurücklassen	hinterlassen	vernachlässigen	verlorene Gegenstände						
dance (n./v.)	Tanz												
nothing	ohne	nichts	nicht vorhanden sein	nicht									
comfort (v.)	trösten	Trost zusprechen											
moreover	für einen Moment	für eine lange Zeit	selbst	sogar	sowohl … als auch …								
older sister	ältere Schwester												
group (n.)	Gruppe	organisieren	gründen	bilden									
ancestor	Vorfahr	Ahn	Großvater	Gründer	Urheber	Stifter							
assist (v.)	helfen	beistehen	unterstützen										
side by side	gleich	gleichzeitig	und										
universal	allgemein	universal											
profession	Branche	Wirtschaftszweig	Beruf	Beschäftigung	Gewerbe	Job							
that‘s right	gegenüberliegen	gegenüber	entgegengesetzt	richtig	korrekt	stimmen							
together	gemeinsam	gleich	allgemein	zusammen									
supply (n./v.)	liefern	versorgen	bereitstellen	anbieten	Angebot	Zufuhr							
different	verschieden												
lane	Gasse												
port (n.)	Hafen												
choose	auswählen	auslesen	wählen	Wahl	ausgewählte Werke	Anthologie							
well (n.)	Brunnen												
Asia	Asien	schwächer als	zweitrangig	unterlegen									
evil (n./adj.)	Übeltat	Bosheit	Untat	Laster	böse	schlecht	übel						
angle	Horn	Geweih	Ecke	Winkel									
untie	öffnen	aufbinden	auftrennen	trennen	lösen	losmachen	verstehen	begreifen					
orifice	Mund	Öffnung											
once more	noch einmal	nochmals	wieder										
weigh	nennen	benennen	bezeichnen	wiegen									
lecture (v.)	sprechen	sagen	reden	erzählen	erläutern	erklären	auslegen						
frame (v.)	konstruieren	formen	bilden	zusammensetzen									
flat (adj.)	flach	platt											
piece of writing	Aufsatz	Schrift	ein beschriebenes oder bedrucktes Papier	Blatt	(Schriftstück)								
compile	flechten	organisieren	einordnen	zusammenstellen	etw. redaktionell bearbeiten	verfassen	komponieren						
theory	analysieren	besprechen	Theorie										
wheel	Rad												
canon	Maßstab	Gesetz	Kanon	Standardwerk	Anspielung auf eine klassische Literaturstelle								
family name	des Namens	von der Familie	(Nachname?)										
paper	Papier												
dusk	Abenddämmerung	verwirrt	konfus										
marriage	heiraten	sich verheiraten	Ehe										
low	niedrig	tief											
bottom	Boden	Sohle	Grund	wahrer Grund	innere Zusammenhänge								
people	Volk	Bevölkerung											
slumber (n.)	schlafen	Schlaf											
Fu	Fu	höflicher Anrede- oder Namenszusatz											
patch (v.)	flicken	reparieren	ausbessern										
knowledgeable	reich	umfassend	groß	weit ausgedehnt	im Überfluss vorhanden	mit etw. reich ausgestattet	gewinnen	erlangen	finden				
wrestle	kämpfen	ringen	Kampf										
metropolis	Hauptstadt	Metropole	Großstadt										
department	Teil	Abschnitt	Einheit	Amt	Ministerium	Abteilung							
young man	(Anrede für Männer) Herr	Herr	Liebster	Geliebter									
countryside	Land	ländliche Gebiete	Dorf										
echo (n.)	Laut	Schall	Geräusch	Echo									
section (n.)	Abschnitt	Teil	Stück	Strecke									
forge (v.)	schmieden												
unreal	unwirklich	trügerisch	illusorisch	magisch	zauberhaft								
take charge of	führen	verwalten	bewirtschaften										
word (n.)	Wort												
boat	Boot	Kahn											
ship (n.)	Schiff	Boot											
sort (n.)	Art	Weise	Sorte										
tray	Teller	Tablett	Platte										
relocate	etw. an einen anderen Platz legen	etw. an einen anderen Platz tragen	fortschaffen	befördern	umlegen	umstellen	umziehen	den Wohnsitz wechseln	übersiedeln				
melon	Kürbis	Gurke	Melone										
orphan	vaterlos	elternlos	verwaist										
benefit (n.)	Vorteil	Nutzen	Überlegenheit										
vacation (n.)	Urlaub	Ferien											
shrimp	Garnele	Krabbe											
air (n.)	Gas	Luft	Lebensenergie										
vapor	Dampf	Wasserdampf											
fly (v.)	fliegen												
face-to-face	Gesicht	mit Blick nach	von Angesicht zu Angesicht	Fläche	Außenseite	Aspekt							
noodles	Mehl	Nudel											
leather (n.)	Leder	verändern	transformieren										
shoes	Schuh												
fragrant	Wohlgeruch	starker und durchdringender Wohlgeruch	intensiver Duft										
voice (n.)	Stimme	Laut	Geräusch										
Wu	Wu	das Reich Wu											
amusement	jm Vergnügen bereiten	amüsieren	Freude	Spaß	Unterhaltung								
error	falsch	irrig	Fehler	Irrtum									
undertake	tragen	auffangen	übernehmen	etw. auf sich nehmen									
steam (v.)	dämpfen	verdampfen	verdunsten										
tooth	Zahn												
pass through	bohren	durchlöchern	durch etw. gehen	anziehen	ankleiden	anhaben	tragen						
wow!	oh	ah	(Überraschung)										
explain	erklären	erläutern	interpretieren										
try (n.)	Mal	… mal	mal										
turn over	umdrehen	umkehren	durchwühlen	stöbern	übersetzen	übertragen							
broadcast (v.)	säen	die Saat ausstreuen	senden	verbreiten	übertragen								
fur	Haar	Federn	Daune	Flaum	(Fell)								
tail	Schwanz												
dwelling (n.)	Haus	Wohnung											
entrust	etw. auf der flachen Hand tragen	Stütze	Ständer	beauftragen	jn mit etw. betrauen	vorschützen	vorgeben	sich auf etw. stützen					
act (v.)	tun	handeln	machen										
bogus	falsch	unecht	gefälscht	vorgetäuscht	Schein-								
long	lang												
stretch (v.)	Zhang	öffnen	spannen	flacher Gegenstand									
swell (v.)	durch Wasser aufschwellen	quellen											
cover (n.)	Hülle	Umhüllung	Gehäuse	Futteral	Überzug	Satz	Reihe						
hair of the head	Kopfhaar	Haar											
unfold	entfalten	entrollen	etw. zur Entfaltung bringen										
funeral	Trauer												
wild goose	Wildgans												
ought to	sollen	es gebührt sich	antworten	entgegnen	zustimmen	zusagen							
bird	Vogel												
hawk	Adler	Habicht	Falke										
duck (n.)	Ente												
island	Insel												
encounter (v.)	begegnen	treffen											
ten thousand	zehntausend												
stride (v.)	treten	schreiten	Schritte nach vorn machen										
ridge of a hill	Kamm eines Hügels	Grat eines niedrigen Berges											
just now	gerade eben	gerade	eben	genau	exakt								
deficient	mangeln	fehlen	an etw. gebrechen	lückenhaft	schadhaft	mangelhaft							
treasure (n.)	Schatz	Kleinod	Wertsachen	Wertgegenstände									
remote (adj.)	fern	weit entfernt	weit										
shake (v.)	schütteln	schwingen	schaukeln	schwenken	winken								
rabbit	Hase	Kaninchen											
flee	fliehen	verloren	inneres Wohlgefühl	Muße	Behagen	Gemütsruhe							
avoid	vermeiden	verhüten	verbieten	etw. nicht erlauben	jn von etw. befreien	jm etw. erlassen	jn von etw. entbinden						
nightfall	Abend	spät											
elephant	Elefant												
likeness	Porträt	Bild	Abbild										
horse	Pferd												
mama	Mama	Mutti											
scold (v.)	schimpfen	beschimpfen	fluchen										
yes or no	ja oder nein	Fragepartikel											
check (v.)	prüfen	kontrollieren											
ride (v.)	reiten	radfahren											
startled	erschrecken	bestürzt sein	stören	aufschrecken	scheuen	durchgehen	wild werden						
tiger	Tiger												
ponder	denken	nachdenken	überlegen										
location	Ort	Platz	Stelle	Punkt									
frolic	spielen	sich tummeln	Späße machen	necken	scherzen	Theaterspiel	Oper						
drama	Schauspiel	Theater											
certificate	Beweis	Nachweis	nach	gemäß	laut	zufolge							
deer	Hirsch	Reh	Rotwild										
dust (n.)	Staub	irdische Welt											
lovely	hübsch	schön											
bear (n.)	Bär												
ability	Fähigkeit	Können	fähig										
attitude	Erscheinungsform	Zustand	Aggregatszustand										
sign of the tiger	Tierkreiszeichen Tiger												
perform	aufführen	spielen											
sign of the dragon	Tierkreiszeichen Drache												
morning	Morgen	Frühe	Morgenfrühe										
agriculture	Landwirtschaft	Ackerbau	Bauer	Landwirt									
concentrated	dicht	dick	stark	dickflüssig	konzentriert								
deliver	senden	schicken	bringen	schenken									
ghost	Geist	Gespenst	Spuk										
demon	Teufel	Dämon	Monster	böser Geist									
lump (n.)	Klotz	Klumpen	Stück										
dragon	Drache	Symbol des Kaisers	kaiserlich										
raid (v.)	überfallen	überrumpeln	über jn herfallen										
youngster	Jugendlicher	Sohn	Kind										
old	alt	veraltet	überholt	altmodisch	abgenutzt	abgetragen	verbraucht						
write	schreiben												
diarrhea	Durchfall	dahinströmen	herabströmen	schnell abfließen									
dos	zwei	zwo											
duo	beide	zwei											
full	voll	erfüllt											
you (literary)	du	ihr	Ihr	du (literarisch)									
fill (v.)	übervoll sein	überfüllen	bedecken	zudecken	verstopfen	abdichten							
false	leer	nichtig	umsonst	vergebens	vergeblich	falsch	scheinbar	vorgetäuscht	bescheiden	nicht überheblich			
unite	vereinigen	verbinden	gemeinschaftlich	verbunden									
shut (v.)	zumachen	schließen	verschließen	ausmachen	abstellen	abschalten							
that	das	jenes	jener	in diesem Fall	dann								
which?	welcher	welches											
witch	Hexenmeister	Hexe	Schamane										
spirit	Geist	Seele	Intelligenz	geistreich	gewandt	geschickt	flink	wirkungsvoll	effektiv				
county	Kreis	Kreis (Gebiet)	Bezirk	Landkreis									
suspend	hängen	aufhängen	ungelöst	ergebnislos	schwebend								
offer (v.)	geben	anbieten	gewähren	mit jm gut auskommen	unterstützen	jm zu etw. verhelfen							
lift up	heben	erheben	hochhalten	Akt	Aktion	Tat							
brain	Gehirn	Hirn											
annoyed (adj.)	sich ärgern	ärgerlich werden	verärgert sein										
specialty	spezial	nur	besonders	eigens	auf etw. konzentriert								
spread (v.)	weitergeben	weiterschicken	verbreiten	sich verbreiten	überliefern								
rotate	sich drehen	rotieren											
troupe (n.)	rund	kreisförmig	Knödel	Kloß	Gruppe	Einheit							
yellow	gelb												
extensive	weit	breit	ausgedehnt	extensiv	Guangzhou	Guangdong							
horizontal	horizontal	quer	längs	waagerecht									
window	Fenster												
general (adj.)	zusammenfassen	zusammenstellen	allseitig	total	immer	stets							
verbose	Zhan												
assume	Lasten mit einer Schulterstange tragen	übernehmen	etw. auf sich nehmen										
number (n.)	Zahl	Anzahl	Nummer										
multistory building	Gebäude	Stockwerk	Etage	Turm									
alone	einzig	allein	in Einsamkeit	alt und kinderlos	kinderlose alte Leute								
belong to	Kategorie	Genus	gehören	unterstehen	einer Institution usw. unterstellt sein								
spoiled	verderben	faulen	verwesen	verfault									
orchid	Orchidee	Cymbidium goeringii											
follow	aus	von	ab	folgen	befolgen	sich fügen	gehorchen						
vertical	von Norden nach Süden	senkrecht	vertikal										
identical	Qi-Reich	ordentlich	gleichmäßig	in Reih und Glied	gleich hoch sein	gleich	in gleicher Weise	gleichermaßen					
relieve (v.)	übersetzen	einen Fluss überqueren	helfen	unterstützen									
clown	Tierkreiszeichen Büffel	Clown	hässlich	garstig	unansehnlich	abscheulich	scheußlich						
twist (v.)	sich wenden	sich drehen	verdrehen	verrenken									
lowly	niedrig	gemein	niederträchtig	infam	minderwertig								
brand (n.)	Schild	Platte	Tafel	Marke	Warenzeichen	Spielkarten	Dominosteine						
appellation	Name	Bezeichnung	Tag										
peculiar	merkwürdig	seltsam	sonderbar	wunderlich	kurios								
crimson	rot	treu	loyal	ergeben	nackt	bar							
likewise	auch	ebenso											
extreme (n.)	Extrem	Pol	extrem										
miscellaneous	verschiedenartig	mannigfaltig	divers	gemischt	vermischt								
sayeth	sagen	nennen	bezeichnen	einen Namen geben									
chaos	Unordnung	Verwirrung	Chaos										
trumpet (n.)	Peng!	Trompete											
mutter	girren	gurren	gackern	Gluck!									
we (inclusive)	wir (den Sprecher einschließend)												
string together	aufreihen	aneinanderreihen	etw. auf eine Schnur ziehen										
overspread (v.)	bedecken	zudecken	überziehen	Deckel	Haube	Kappe	Schutzhülle	Ummantelung					
hubbub	Lärm	Getöse	Tumult										
invert	Scheitel	Gipfel	Spitze	holpern	rütteln	umfallen	stürzen						
talkative	begünstigt werden	bevorzugt werden											
scrape (v.)	schaben	abschaben	Kleister u.ä. auf etw. auftragen										
stare at	starren	fixieren	etw./jn nicht aus den Augen lassen										
rebuke (v.)	hauchen	beschimpfen	schelten										
adultery	unerlaubtes sexuelles Verhältnis	Unzucht											
baby	Säugling	Baby	Kleinkind										
father‘s sister	Schwester des Vaters	Tante											
nanny	Kindermädchen	Erzieherin	Gouvernante										
cautious	vorsichtig und gewissenhaft	behutsam und verantwortungsbewusst											
big	groß												
lay brick	mauern												
whistle (n.)	Pfeife	Vogelgezwitscher											
sway (v.)	schwenken	hin und her bewegen											
moor (v.)	anlegen	am Kai festmachen	ein Schiff festmachen	ein Schiff vertäuen									
get rid of	ausscheiden	eliminieren	absondern										
soak	befeuchten	anfeuchten	eintauchen	tränken	mit etw. beschmutzt	besudelt	befleckt						
insignificant	fern und undeutlich	in der Ferne verschwimmend	sehr klein	unbedeutend	winzig								
gland	Drüse	Glandula											
level (adj.)	eben	flach	seelenruhig	gelassen	ruhig und furchtlos								
newborn (n.)	Baby	Säugling	kleines Kind										
bank (n.)	Rand	Grenze											
inch	Zoll	englisches Zoll											
elbow (n.)	Ellbogen												
scorch	brennen	verbrennen											
stir-fry (v.)	etw. in der Pfanne kurz braten	sautieren											
sprinkle	etw. mit Wasser besprengen	durchnässen	gießen	bewässern	berieseln								
mile	Meile	englische Meile											
carp (n.)	Flusskarpfen												
Hey!	he	heda	hallo										
cinnabar red	rot	Pille	Medikament (in Pillen- oder Pulverform9										
boisterous	laut	lärmend											
visitor	Gast												
water‘s edge	Ufer	Strand	Gestade	Rand eines Gewässers									
widowed	verwitwet	Witwe	wenig	karg	gering	spärlich	geschmacklos						
shed (n.)	Schutzdach	Sonnendach	Hütte	Schuppen									
cypress	Zypresse												
thick stick	kräftiger Stock	feste Tragstange	Reck- und Barrengeräte										
flouds	Blüte oder Wolke	Blolke											
prevent	versperren	stopfen											
cassia-bark tree	chinesischer Zimt	Lorbeerbaum	Duftblüte	Osmanthus									
chair	Stuhl												
hero	Held	Heros	überragend	außergewöhnlich	hervorragend								
cherry	Kirsche	Blütenkirsche											
treetops	Zweigspitze	dünnes Ende eines Zweigs u.ä.											
paulownia	Paulownie	Tungölbaum											
Song	Song	Song-Dynastie											
drench	filtrieren	durchseihen	durchsieben										
burn (v.)	brennen	verbrennen											
obscure (adj./v.)	blind	unklar	finster	dunkel	von etw. nur eine verschwommene Vorstellung haben	etw. nicht wissen	verstecken	verbergen	unterschlagen				
vermilion	scharlachrot	zinnoberrot											
tree trunk	Baumstamm	Pflanze											
roof beam	Dachbalken	Brücke											
saucer	kleiner Teller	Tellerchen											
bud (v.)	keimen	sprießen	knospen										
exacting	zu streng	zu genau	zu hart	rücksichtslos									
membrane	Membran	Folie	Film	dünner Überzug									
solitary	einsam	verlassen											
sunset	Abend	Abenddämmerung	bei Sonnenuntergang	am Ende	gegen Ende hin	spät							
ignite	brennen	anbrennen	anzünden										
curse (v.)	Zauberformel	beschimpfen	verfluchen										
beast	Tier	Bestie	bestialisch										
raccoon dog	Marderhund												
sniff (v.)	beriechen	schnüffeln	schnuppern	wittern									
dude	männlich (von Tieren)	männlich											
jail	Gehege	Pferch	Viehhürde	Opfertier	Gefängnis	Kerker							
succor (v.)	helfen	beistehen	unterstützen										
abode	Haus	Hütte	mein										
wha?	was	was?											
in agreement	einträchtig	harmonisch	einig	im Einvernehmen	verhandeln								
thriving	blühend	üppig											
green jade	grüner Jade	bläulich											
tearful	(Wasser) tief und weit	(Flüssigkeiten) sich ansammeln, sich stauen	sich stauen										
crooked	krumm	schräg	biegen	verdrehen	entstellen	jm Unrecht tun	jn zu Unrecht beschuldigen						
pearl	Perle												
shocking	schrecklich	entsetzlich											
crocodile	Krokodil	Alligator											
fight (v.)	kämpfen	streiten	ringen	Kampf									
plug (n.)	Riegel	Hahn	Pfropfen	Stöpsel									
pillar	Pfeiler	Säule	Stütze	Pfosten	Pflock	Zylinder							
hook (n./v.)	Haken	anhaken	einhaken	hakenförmiger Strick									
paper money	Banknote	Geldschein											
put up for sale	Metall schmelzen	aufheben	annullieren	etw. rückgängig machen	absetzen	verkaufen							
lock (n./v.)	Schloss	verschließen	zuschließen										
drill (n./v.)	Bohrer	bohren	Diamant										
compel	zwingen	erzwingen	aufzwingen										
press (v.)	nötigen	auf jn Druck ausüben	zwingen										
escape (v.)	fliehen	flüchten	die Flucht ergreifen	ausreißen	entgehen	entkommen	entfliehen	entschlüpfen					
flaunt	etw. stolz zur Schau tragen	etw. stolz zur Schau stellen	prunken										
rumble (n./v.)	bum!	bums!	donnern	dröhnen	beschießen	bombardieren							
rails	Gleis	Schiene											
flatten	rollen	walzen	verdrängen	ausstoßen									
spokes	Speiche												
sauté (v.)	etw. in wenig Öl braten	kochen	Kräuteraufguss										
figure of speech	Beispiel	Analogie	erläutern	erklären	informieren	jn über etw. in Kenntnis setzen							
elm	Sibirische Ulme	Ulme											
abbreviation	knapp	kurz und bündig	kurze Darstellung	Abriss	Umriss	auslassen	weglassen						
dizzy	schwindlig	von Schwindel befallen	in Ohnmacht fallen	ohnmächtig									
muddled	trübe	unklar	verschmutzt	dämlich	dusslig	bescheuert							
ointment	Paste	Creme	Salbe	Fett	Schmalz								
go smoothly	reibungslos	zügig											
hum (v.)	schnauben	stöhnen	leise singen	summen									
honest	rein	schlicht	ehrlich	aufrichtig									
whale	Wal												
redeem	(Pfand) einlösen	einlösen	(Untat, Verbrechen) sühnen	sühnen	Sühne leisten	wiedergutmachen	für etw. bezahlen						
daylight	Tag	Tageszeit											
Tianjin	Furt	Fähre	Tianjin										
smidgen	Li (1/3 mm)	Bruchteil	Geringste	My									
small objects	ZEW für kleine Dinge	kleine Dinge											
herd (v.)	Vieh hüten	Vieh weiden											
rose	Rose												
candid	ehrlich	aufrichtig	anständig	bieder									
promise (n.)	Versprechen	Zusage											
meaning	Sinn	Bedeutung	sagen	nennen	heißen								
inquire	nach etw. fragen	sich nach etw. erkundigen											
penalize	strafen	rügen	Strafe										
place an order	bestellen	buchen	abonnieren										
chant (v.)	rezitativisch singen	psalmodieren	in poetischer Form erzählen	(Ode?)									
espionage	Spionage	Spion	Geheimdienstagent	Geheimagent									
annotate	anmerken	mit Anmerkungen versehen	Anmerkung										
forgive	verzeihen	entschuldigen	ich nehme an	ich gehe davon aus									
praise (v.)	loben	rühmen	preisen	Lobschrift	Lobrede								
II	II	Schreibweise der Zahl zwei auf Schecks, Banknoten etc.											
sick and tired of	fettig	ölig	einer Sache überdrüssig sein	etw. satt haben	peinlich genau								
discharge (v.)	entweichen	ausströmen	ein Geheimnis preisgeben	preisgeben	Nachrichten offenbaren	offenbaren	Luft machen	freien Lauf lassen					
paddle (v.)	rudern	paddeln											
caw (n.)	krachen	quietschen	quaken										
domain	innerhalb bestimmter Grenzen liegendes Gebiet	Territorium	Region										
sow (v.)	pflanzen	züchten	aufstellen	aufpflanzen	jn zu etw. abstempeln	aufbürden							
kin	Verwandter												
despise	geringschätzen	verachten	verleumden	verunglimpfen									
yell (v.)	rufen	schreien											
splatter (v.)	sprühen	spritzen											
address (n.)	Standort	Ort	Sitz										
astringent	von unangenehmem und betäubendem Geschmack	nicht glatt	hemmend										
apple	Apfel												
go to	gehen	sich begeben											
trip	Fahrt	Mal											
dike	Damm	Deich											
keyboard keys	Taste												
son-in-law	Schwiegersohn												
tailor (v.)	schneiden	zuschneiden	abschneiden	ausschneiden	beschneiden	verringern	reduzieren	entlassen					
socks	Socke												
trundle (v.)	rollen	wälzen	sich davonscheren	sich trollen									
decline (v.)	verfallen	schwach werden											
innermost feelings	Herzensgrund												
meditation	anhaltende kontemplative Versenkung	tiefe Meditation	völlige Meditation	buddhistisch									
ape	Affen												
dangle	hängen	etw. an einem Seil hochziehen bzw. herablassen											
handkerchief	Taschentuch												
note (n.)	schriftliche Einladung	Notiz	Karte										
sail (n.)	Segel												
width of cloth	Breite einer Stoffbahn	Größe	Umfang	Format									
brocade	Brokat												
copious	reichlich												
persimmon	Kakipflaume	Kaki	Persimone										
stir up trouble	lärmen	Krach schlagen	Radau machen										
thorn bushes	Dorn	Dornbusch											
jujube	Jujube	Chinesische Dattel											
flower bud	Knospe												
gulp down	verschlingen	schlucken	verschlucken										
bewitching	lasziv	aufreizend	liederlich	boshaft und tückisch	Dämon	Gespenst							
fertile	fruchtbar	ertragreich	bewässern										
sedan chair	Sänfte												
garbage	Abfall	Müll	Kehricht										
weep aloud	weinen	heulen	krähen	schreien									
fruit stem	Blütenkelch												
drip (v.)	tropfen	Tropfen											
100 Chinese acres	100 chinesische Morgen	Qing											
spoon (n.)	Löffel	Schöpfkelle											
well-behaved	brav	artig	manierlich										
hitch a ride	fahren												
leftover (adj.)	übrigbleiben	als Rest zurückbleiben											
club (n.)	Stange	Stock	Stab										
in accord	in Harmonie	in Übereinstimmung mit	zu einer Vereinbarung kommen	mit jm übereinkommen									
firewood	Brennholz												
quick-witted	flink	behende											
mildew (n.)	Schimmel	Schimmelpilz											
so far	bis jetzt	die ganze Zeit über											
chop (v.)	fällen	hacken	hauen	(einen Text u.ä.) kürzen									
hump (n.)	Bodenerhöhung	(Hürde?)	(Hindernis?)										
cook (v.)	kochen	Essen zubereiten											
think highly of	hochachten	respektieren	verehren	vom Kaiser persönlich									
cut open	aufschneiden	analysieren	untersuchen										
bodhisattva	Bodhisattwa	Buddha	Buddhafigur										
mango	Granne	Chinaschilf	Mango										
wasteland	öde	brachliegend	Ödland	unkultiviertes Land									
lie (n.)	Lüge	Unwahrheit											
boundless	grenzenlos und verschwommen	weit und schemenhaft	ahnungslos	im Dunkeln tappen									
win (v.)	siegen	gewinnen											
interrogate	nach etw. fragen	ausfragen	verhören	vernehmen									
workshop	Werkstatt	Werkstätte	Betrieb										
aromatic	duftend	wohlriechend											
call on	besuchen	einen Besuch machen	aufsuchen										
stew (v.)	langsam kochen	abkochen	auskochen	durchhalten	aushalten	ertragen	leiden	vegetieren					
tobacco	Tabak	Zigarette											
roster	Namensliste	öffentlich ausgehängte Namensliste											
pound (n.)	Pfund	(englisches Pfund?)											
upper arm	Oberarm	Schulter	Arm										
sharp	scharf	spitz	schneidend										
rainbow	Regenbogen												
bat (n.)	Fledermaus												
frog	Frosch												
locust	Heuschrecke												
cicada	Zikade												
maple	Ahorn												
placenta	Nachgeburt mit Fruchtblase	Plazenta	Mutterkuchen										
fireworks	Kanone	Geschütz	Feuerwerk	Knallfrosch	Kanone (im chin. Schach)								
robe (n.)	langes Oberkleid	Robe											
hail	Hagel												
pursue	verfolgen	nachjagen	vertreiben	ausweisen	hinausjagen								
satisfy	zufriedenstellen	befriedigen											
Mongolia	Monggol-Nationalität	Mongolei											
dim (adj.)	mattes Mondlicht	unklar	verschwommen	neblig	dunstig								
unrestrained	Person von überragender Fähigkeit	mannhaft und beherzt	frei und ungezwungen	unbändig	despotisch	gewalttätig							
peck (v.)	picken	klopfen											
chisel (v.)	schnitzen	meißeln											
marry	einen Mann heiraten	heiraten											
intestines	Darm	Wurst											
poplar	Pappel												
scald	sich verbrennen	sich verbrühen											
licentious	unmoralisch und ausschweifend	seichter See											
detailed	ausführlich	sehr genau	eingehend	Detaildarstellung									
envy (v.)	beneiden	bewundern											
solely	nur	allein											
pile (n./v.)	häufen	aufstapeln	auftürmen	Haufen	Stapel								
apprehensive	gebrannt	verbrannt	verkohlt	Koks	besorgt	beunruhigt							
lay eyes on	sehen	schauen											
reef	Riff	Klippe											
banana	Banane	Bananengewächse											
sculpture	schnitzen	stechen	eingravieren	Schnitzarbeit	Schnitzerei	Geier							
lop off	abschneiden	zerschneiden											
allow	genehmigen	erlauben	bewilligen										
sparrow	Spatz												
all at once	auf einmal	plötzlich											
exert oneself	sich anstrengen	sich aufraffen	aufheben	erheben									
take by force	etw. gewaltsam wegnehmen	etw. an sich reißen	rauben	entreißen									
turn upward	sich an einem Ende in die Höhe heben	sich nach oben biegen (od. krümmen)											
fall down	einstürzen	zusammenbrechen	zusammenfallen	einsinken	einfallen								
writing brush	Pinsel	Feder	Schreiben	Brief									
throat	Rachen												
in-law (adj.)	angeheiratete Verwandschaft												
temple	Tempel	buddhistischer Tempel	Tempelmarkt										
side room	Flügelzimmer	seitliche Teile eines ebenerdigen Hauses	Seitenraum	Abteil	abgeteilter Raum								
(pause marker)	Markierung einer betonenden Pause	Markierung von Offensichtlichem											
grind (v.)	reiben	zerreiben	schleifen	polieren	wetzen								
skyscraper	Hochhaus	großes Gebäude											
toilet	Toilette												
realize	verstehen	auf einmal verstehen	gewahr werden	nach langer Überlegung zur Einsicht kommen	jm geht ein Licht auf								
loyal	treu	getreu	loyal										
mourn	um jn trauern	betrauern	jm nachtrauern										
prudent	vorsichtig	achtsam											
pardon (v.)	vergeben	verzeihen	entschuldigen										
noiseless	still	ruhig	ganz leise	traurig	betrübt								
all of a sudden	schlagartig	schlagartig klarwerden	ganz plötzlich	ganz plötzlich begreifen									
indolent	faul	träge	lässig										
immense	ausgedehnt	weit	weiträumig										
permanent	lange Zeit	andauernd	ständig	beständig									
admire	sich sehnen	nach etw. verlangen	für etw. Neigung haben	(bewundern?)									
just right	passend	treffend	recht	geeignet	gerade	genau	das rechte Maß halten						
fearful	Furcht	Angst	Beklemmung										
overjoyed	glücklich	fröhlich	heiter	gut gelaunt	gut aufgelegt	freundlich							
more and more	besser	je mehr … desto …											
be bewildered	verwirrt	verblüfft	konfus										
terror-stricken	von Furcht gepackt werden	von panischem Schrecken ergriffen sein	stutzen										
be scared of	Angst	Furcht	vor etw. Angst haben										
augment	hinzufügen	ergänzen	gebären	ein Kind bekommen									
be sorry about	bedauern	bereuen											
nervous	unruhig	nervös	konfus	verwirrt									
delighted	fröhlich	glücklich	erfreut	erfreuen	ergötzen	entzücken	Freude machen						
loathe	hassen	verabscheuen	Ekel vor etw. empfinden										
shun	scheuen	vermeiden	sich von etw. fernhalten	fürchten	befürchten								
thinking	Denken	allein	einzig	nur	aber								
be frightened	Angst	Furcht	Schrecken										
troubles	Unheil	Katastrophe	sich sorgen	sich kümmern	an einer Krankheit leiden								
provoke	hervorrufen	veranlassen	verursachen	herbeiführen	reizen	necken	foppen						
kindness	Wohltat	Gunst	Güte	Gnade									
recall (v.)	sich erinnern	zurückdenken	sich etw. ins Gedächtnis zurückrufen										
daughter-in-law	Schwiegertochter												
put out	löschen	erlöschen	auslöschen										
Chinese harp	zitherähnliches Zupfinstrument	chinesisches Saiteninstrument	chinesische Harfe										
secrete	absondern	ausscheiden											
honey	Honig	süß	honigsüß										
rub (v.)	reiben	schaben	studieren	nach etw. forschen	über etw. nachgrübeln								
moth	Motte												
pick pockets (v.)	zusammenrechen	zusammenharken	auf kleiner Flamme weich kochen	schmoren									
button (n./v.)	zuknöpfen	zuschnallen											
contribute	spenden	stiften	beisteuern	verzichten	aufgeben	hingeben	opfern						
racquet	Schläger	klatschen	klopfen	leicht schlagen	etw. mit einer Kamera aufnehmen								
clapping sound	knall	klapp	peng	Klatschgeräusch									
damage (v.)	schaden	beeinträchtigen	jn mit sarkastischen Worten kränken										
carry over the shoulder	schultern	auf der Schulter tragen											
prick (v.)	stechen	piken											
thumb	Daumen	große Zehe											
detain	verhaften	festnehmen	inhaftieren	befangen	gehemmt	unbeweglich	unflexibel	begrenzen	einschränken				
copy (v.)	abschreiben	kopieren	plagiieren										
pioneer (v.)	etw. urbar machen	roden	erschließen										
pinch (v.)	etw. zwischen den Fingern halten	etw. mit den Fingern nehmen	herausfingern	etw. zwischen den Fingern rollen, kneten und formen									
chafe	sich kratzen	hindern											
smear on	streichen	aufstreichen	bestreichen	schmieren									
describe	etw. nach einer Vorlage zeichnen	abpausen	übermalen	retuschieren									
grope	betasten	berühren	befühlen	streicheln	tätscheln								
foment	schüren	anstiften	aufstechen	stochern	etw. mit einem Stock oder einer Stange hochheben								
tether (v.)	binden	anbinden											
tidy up	auflesen	finden	(vom Boden) aufheben										
put up	bauen	erbauen	errichten	etw. an, auf oder über etw. hängen									
pillage (v.)	plündern	berauben	rauben										
abandon	aufgeben	auf etw. verzichten											
wipe away	wischen	abwischen											
yank (v.)	ziehen	zerren	reißen	abreißen									
drag (v.)	schleppen	ziehen	hinauszögern	verzögern									
publicize	aufheben	aufrichten	worfeln	verbreiten	etw. in Umlauf bringen								
engage in	tun	machen	verrichten	sich mit etw. beschäftigen	fertigen	erzeugen	schaffen	gründen	errichten	erbauen			
bump into	zusammenstoßen	stoßen	treffen	begegnen									
handpick	pflücken	abnehmen	auswählen	ausziehen									
lash together	festbinden	zusammenbinden	bündeln	ein Bündel schnüren	Bündel								
joggle (v.)	schütteln	rütteln	etw. ins Schwanken bringen										
harass	stören	belästigen											
act without authority	sich etw. anmaßen	eigenmächtig	unbefugt	in etw. gewandt sein									
altar	Altar	Plattform	Tribüne	Podest									
tremble	zittern	beben	vibrieren										
rude	üppiges Gras	waghalsig	draufgängerisch										
take precautions against	sich vor etw./jm hüten	sich vor etw./jm in acht nehmen	auf etw. achtgeben	vorbeugen	warnen	mahnen	ermahnen						
weapon	Werkzeug	Gerät	Waffe	Straf- und Folterinstrumente									
warn	warnen	verwarnen	ermahnen	Gebot									
dash (v.)	schnell laufen	rennen	eilen										
spurt (v.)	sprühen	speihen	spritzen	sprengen									
tomb	Grab	Grabstätte											
indignation	Entrüstung	Zorn	Ärger	Groll	sich entrüsten	in Zorn geraten							
stuff (n.)	Material	Nutzholz	Veranlagung	geistige Anlage									
pregnant	Schwangerschaft	schwanger											
throw away	wegwerfen	etw. über Bord werfen	werfen	schleudern									
trash (n.)	Müll	Kehricht											
fork (n.)	Gabel	gabeln	aufgabeln										
mulberry tree	Maulbeerbaum												
voicebox	Kehle	Hals											
outlaw (n.)	Bandit	Eindringling	Feind	eindringen	einfallen	überfallen							
knock (v.)	schlagen	klopfen	abluchsen										
pour into	bewässern	berieseln	füllen	eingießen									
authority	Recht	Berechtigung	Macht	Befugnis									
resolute	standhaft	fest entschlossen											
limb	Glied	Glied (eines Körpers)	Gliedmaße										
prostitute	Prostituierte	Dirne	Freudenmädchen										
fork in the road	sich gabeln	sich verästeln	sich in Zweige spalten										
fins	Flügel	Flosse	Haifischflosse										
graceful	zärtlich	nett	liebenswürdig										
spice plant	Gewürzpflanzen, denen ein scharfer Geschmack eigen ist												
queen	Kaiserin	Königin											
shield (n.)	Schild	Vorwand	Ausrede										
peddler	etw. zum Wiederverkauf erwerben	als Zwischenhändler einkaufen	Händler	Hausierer									
tug (v.)	drehen	ziehen	umschalten										
try to find	suchen												
appropriate (adj.)	geeignet	angemessen	zweckmäßig										
notice (v.)	jn beachten	von jm Notiz nehmen											
consent (v.)	erlauben	billigen	einwilligen										
cross out	anhaken	anstreichen	wegstreichen	skizzieren	konturieren	umreißen							
promote	eintreten	vorgehen	vorrücken	befördert werden									
magnificent	groß	großartig	grandios										
fetus	Fötus												
smelt (v.)	Erze verhütten	Metall schmelzen	verhütten	schmelzen									
typhoon	Taifun												
negligent	träge	nachlässig	bummelig										
elevate	heben	aufheben	hochheben										
mislay	verlieren	zuwerfen	wegwerfen	schmeißen	beiseitelegen	liegenlassen	aufgeben						
Taiwan	Taiwan												
bring about	verursachen	herbeiführen	sich widmen	sich für etw. einsetzen	senden	schicken	übermitteln						
remove	entfernen	fortnehmen	wegschaffen										
sulfur	Schwefel												
glaze (n.)	Farbglasur	Glasur											
sparse	ausbaggern	licht	weit auseinander stehend	spärlich	einander nicht nahestehend	entfernt	distanziert	fremd	unvertraut	vernachlässigen			
veggies	Gemüse												
crumble	einstürzen	zusammenbrechen	platzen	bersten									
rock	Felsen	felsiger Berg											
rugged	uneben	holprig											
cliff	Klippe	überhängende Felswand	steil abfallende Felswand										
charcoal	Holzkohle	Steinkohle											
carbon	Kohlenstoff												
await hopefully	sich nach etw. sehnen	nach etw. verlangen	hoffen	blicken	schauen								
promulgate	erlassen	verkünden	bekanntmachen										
essence	Wohlgeruch	Duft											
play the part of	schmücken	sich verkleiden	sich kostümieren	eine Rolle spielen	darstellen	mimen							
diverge	abzweigen	sich gabeln	sich seitwärts wenden										
extol	rühmen	preisen	Loblied	Hymne	Ode								
litigate	einen Rechtsstreit bei Gericht anhängig machen	prozessieren											
elderly man	alter Mann	Greis											
abundant	reichlich	im Überfluss vorhanden											
banyan	Banyanbaum	Ficus bengalesis											
prize	jn etw. gnädig überreichen / zuwenden	Zuwendung	Geschenk	Auszeichnung	Prämie	prämieren	belohnen						
attempt (v.)	einst	einmal	ehemals	(versuchen)	(probieren)								
taste (v.)	kosten	schmecken	abschmecken										
palm of the hand	Handfläche												
fend off	versperren	abwehren	verhindern	abhalten	verbergen								
chest	Brustkorb	Brusthöhle	Brust										
quite	recht	ziemlich	beträchtlich	zu einer Seite geneigt									
slope (n.)	Abhang	Hang	Böschung										
drape over the shoulders	umhängen	überwerfen											
the other	ein anderer	die anderen	Gegenseite	die andere Seite									
wrinkles	knittern	Falten ziehen											
chick	Vogeljunge	Nestling											
hasten	eilen	hasten											
spinach	Spinat												
breed (v.)	zeugen	fortpflanzen											
dissimilar	verschieden	unterschiedlich	besonders	außerordentlich	speziell	ungewöhnlich							
incomplete	unvollständig	defekt	fragmentarisch										
grin (v.)	den Mund verzerren	die Mundwinkel nach außen ziehen											
crack (v.)	spalten	platzen	zerfallen	Ritze	Fissur								
dedicated	rechtschaffen	aufrichtig	licht	glänzend									
shame (n.)	Scham	Schande	sich schämen										
edit	kompilieren	zusammenstellen	edieren	redigieren									
take a photo	fotografieren	knipsen	aufnehmen	absorbieren	assimilieren								
take a wife	eine Frau heiraten	jn zur Frau nehmen											
lend a hand	(mit der Hand) stützen	stützen	Halt geben	jm unter die Arme greifen	Hilfe leisten	behilflich sein	aufrichten						
splendid	licht	hell	gedeihend	voller Leben	aufblühend	blühend							
kidneys	Niere												
recruit (v.)	sammeln	anwerben	rekrutieren										
threaten	seitlicher Teil des menschlichen Oberkörpers	Brustkorbseite	zwingen	drohen									
inferior	schlecht	minderwertig	von geringer Qualität										
merit (n.)	Verdienst	verdienstvolle Tat	Ruhmestat										
advise	raten	zureden	überreden	aufmuntern	ermutigen								
plunder (v.)	rauben	berauben	plündern	überfallen									
anger (n.)	Zorn	Wut											
eggplant	Aubergine												
seemingly	anscheinend												
go on an expedition	eine weite Reise unternehmen	eine Expedition unternehmen	einen Feldzug unternehmen										
follower	Schüler	Lehrling	Anhänger einer Glaubenslehre										
undecided	unentschlossen												
solicit	um etw. bitten	um etw. ersuchen	jn zum Militärdienst einziehen	Steuern eintreiben	Beweis	Zeugnis	Nachweis						
chasten	bestrafen	strafen											
comply with	nach	gemäß	entsprechend	entlang									
thorough	durch und durch	gründlich	total	völlig									
service	Arbeit	Dienst	Diener										
develop	entfalten	entwickeln	überflüssig (Sätze, Wörter)	überflüssig									
weight	Waagebalken	Arm einer Laufgewichtswaage	Waage	wiegen	abwiegen								
title	Rang	Titel											
bald	kahl	glatzköpfig	haarlos										
decrepit	baufällig	zerfallen	verfallen	ruiniert	dekadent	verdorben	verkommen						
seconds	Sekunde												
a little (adv.)	ein wenig	ein bisschen	etwas										
rise again	wieder zu sich kommen	(auferstehen)											
revive	das Bewusstsein wiedererlangen	wieder zu sich kommen											
wilt	verwelken	verdorren	austrocknen										
sticky	klebrig	leimig											
host (n.)	massenhaft												
wall paint	Lack	Lackfarbe	Anstrichfarbe	lackieren									
knees	Knie												
dense	dick	dicht											
draft (n.)	flüchtige Niederschrift bzw. Zeichnung	Manuskript	Original	Urtext	Getreidehalm	Stroh							
clever	klug	gescheit	Spelze	Kornschale									
tax (n.)	Steuer	Steuerabgabe											
crops	anbauen	säen	Getreide										
fungus	Pilz												
immature	klein	jung	kindlich	kindisch									
harvest (v.)	ernten												
private (adj.)	privat	persönlich											
order (n.)	Ordnung	Reihenfolge	Dekade										
shell (n.)	Schale	Hülse	Hülle	Gehäuse									
cereal	Getreide	Korn	Hirse										
shovel (n.)	Spaten	Schaufel											
hold tight	ergreifen	packen	fassen	festhalten	heftig ziehen								
pear	Birne												
plow (n.)	Pflug	pflügen											
calendar	Kalender												
cake	Kuchen												
batter	Kleister	Klebstoff	Kleber	kleben	kleistern								
glue (v.)	kleben	an etw. haften											
provisions	Körner	Getreide	Verpflegung	Getreidesoll	Getreideabgabe								
chrysanthemum	Chrysantheme												
rough	roh	grob	rauh										
grain	Korn	Körnchen											
brilliant	glänzend	strahlend	glorreich	prächtig	herrlich								
powder	Pulver												
squint (v.)	ins Auge kommen (Fremdkörper)												
currency	Währung	Geld											
die a violent death	ums Leben kommen	umkommen	krepieren	verrecken	verenden								
shelter (n.)	zudecken	verbergen	Schutz gewähren	Zuflucht gewähren									
cast aside	werfen	etw. beiseite legen	jn beiseite legen	jn über Bord werfen	vernachlässigen								
fraud	Betrug	Schwindel											
bamboo shoot	Bambusspross	Bambustrieb											
tube	dickes Bambusrohr	dickes Rohr	Zylinder										
construct	bauen	errichten	erbauen										
stupid	dumm	geistig beschränkt	blöd	blöde									
arrow	Pfeil												
tendon	Sehne	Muskel											
V	V	fünf											
animosity	Feind	Erzfeind	Hass	Feindschaft									
start (v.)	etw. ins Leben rufen und fördern	etw. einführen und sich dafür einsetzen											
father‘s older brother	älterer Bruder des Vaters												
mid-	Mitt-												
estimate (v.)	schätzen	taxieren	veranschlagen										
detect	erkunden	erspähen	auskundschaften	aufklären	nachspüren								
altogether (adv.)	all	ganz	sämtlich	komplett	vollständig								
lateral (adj.)	Seite	seitlich	seitwärts	an der Seite	auf der Seite								
bless	behüten	beschützen	protegieren	segnen	selig preisen	???							
assistant	Hilfe leisten	jm beistehen	Assistenz	Mitarbeiter									
meticulous	Jungtier	jung	das Junge	ein Junges									
comely	schön	hübsch	schick	viel gefragt	reißenden Absatz finden								
if	wenn	falls	im Fall										
count on	sich an etw. anlehnen	sich an jn anlehnen	sich auf etw. verlassen	sich auf jn verlassen	auf etw. gestützt	auf jn gestützt							
superb	gut	schön	ausgezeichnet										
serve	jm aufwarten	jn bedienen											
mate (n.)	Gefährte	Partner	Gemeinschaft	Partnerschaft	gemeinsam								
stay overnight	übernachten												
bend over	sich beugen	auf dem Bauch liegen	jährliche Hitzeperiode	Hundstage									
wrapping cloth	Einschlagtuch	Packtuch											
steal (v.)	stehlen	stibitzen	klauen	heimlich	insgeheim	verstohlen							
fell	fällen	schlagen	umhauen	abholzen									
wear at the waist	etw. am Gürtel tragen	Gürtelschmuck	Gürtelanhänger										
announce	erklären	verkünden	bekanntgeben	veröffentlichen	proklamieren	verbreiten	verteilen	ausbreiten					
live abroad	im Ausland leben												
one hundred million	hundert Millionen												
incline (v.)	sich neigen	geneigt sein	Neigung	Tendenz									
insult (v.)	beleidigen	kränken	demütigen										
times	-fach	-mal											
mimic (v.)	nachahmen	imitieren	kopieren	nachbilden									
haughty	stolz	überheblich	arrogant	hochnäsig	hochmütig								
Buddhist monk	buddhistischer Mönch												
without haste	gemächlich	sich lang erstrecken	fern										
Russia	Russland												
rite	Ritus	Zeremonie	Aussehen	Erscheinung	Haltung								
nephew	Sohn des Bruders	Neffe											
immortal (n.)	Unsterblicher	unsterbliches Wesen											
custom	Sitte	Bräuche	Brauch										
repay	zurückzahlen	wiedererstatten	jn entschädigen										
for sleeping	sich hinlegen	liegen	Schlaf-	zum Zwecke des Schlafens									
close to	nahe bei	in der Nähe von	sich nähern										
we (exclusive)	wir	ich											
inundate	überfluten	überschwemmen											
conceal	bedecken	zuhalten	zudecken	zumachen	zuschließen								
prod (v.)	drängen	antreiben	beschleunigen										
wreck (v.)	brechen	zerbrechen	zerstören										
take along	mitnehmen	(mitbringen)	(etw. in einer Hand tragen)										
symbol	Symbol	Zeichen	Kennzeichen	z.B. Musiknote, Pausenzeichen									
loan (n.)	Kredit	Darlehen											
Holland	Holland												
battle (n.)	Schlacht	Kampf	(eine Waffe) in der Hand haben	Kriegsgeräte	Waffen								
cane	Stock	Stab	Knüppel										
press from both sides	von beiden Seiten zusammendrücken	einzwängen	in die Mitte nehmen										
chivalrous person	ritterlich	ritterlich gesinnt	gerechtigkeitsliebend										
cheek	Wange	Backe											
narrow (adj.)	eng	schmal											
coerce	durch Drohungen veranlassen	jm seinen Willen aufzwingen	unter den Arm nehmen	unter dem Arm halten	unter den Arm klemmen								
gorge (n.)	Schlucht	Enge											
umbrella	Schirm												
assemble	sich versammeln	zusammenkommen	zusammentreffen										
frustrate	vereiteln	durchkreuzen											
saber	(zweischneidiges) Schwert												
restrain	zurückhalten	Einhalt gebieten	zurückziehen										
pick up (v.)	sammeln	auflesen											
sign (v.)	unterschreiben	unterzeichnen											
thrifty	sparsam	genügsam	haushälterisch										
lambsquarters	Gänsefuß	Fuchsschwanz	(Radieschen?)										
kudzu	Kudzu	Kopoubohne											
brown	braun												
use up	aufbrauchen	ausschöpfen	sich erschöpfen	sich anstrengen	sich bemühen								
take a rest	Rast machen	sich ausruhen											
reveal	abnehmen	abheben	aufdecken	entlarven									
promiscuous	ausschweifend	zügellos	unerlaubter Geschlechtsverkehr	unzüchtig									
erect (adj.)	aufrecht	gerade	steif	straff	sich aufrichten								
tile	Dachziegel	tönern											
porcelain	Porzellan												
bottle	Flasche												
aluminium	Aluminium												
palace	Palast												
lustrous	glänzend und durchsichtig	jadeartiger Stein	glänzend										
firefly	Glühwürmchen												
scoop up	herausfischen	etw. aus dem Wasser holen											
glowing	glänzend	leuchtend											
whirl (v.)	kreisen	drehen	sich drehen										
kiss (v.)	küssen	Kuss											
hurriedly	hastig	eilig	überstürzt										
tin	Zinn												
watchful	wachsam	vorsichtig											
bits	Stückchen	Splitter	Krume										
urine	Urin												
brush (n./v.)	Bürste	bürsten	putzen										
rhinoceros	Nashorn												
tardy	spät	verspätet	säumig										
leak (v.)	leck sein	undicht sein	sickern										
fart (n.)	Furz												
footwear	Schuh	Schritt											
excrement	Kot												
folding screen	Wandschirm	Paravent	spanische Wand										
knuckle under	biegen	krümmen	sich beugen	sich bücken	sich nachgiebig zeigen	nachgeben	erlittenes Unrecht						
excavate	graben												
ruler	Lineal	Zollstock											
eyebrows	Augenbraue	Braue											
flatter	schmeicheln	sich einschmeicheln											
shoulder (n.)	Schulter												
jealous of	neiden	eifersüchtig	neidisch										
tears	Träne												
enlighten	aufklären	belehren	öffnen	aufmachen	starten	anfangen							
fan (n.)	Fächer	Flügel											
can‘t help but	ertragen	zurechtkommen mit	?										
funds	Geldmittel	Gelder	Geldsumme										
evil spirit	Gespenst	böser Geist	böse Geister										
wish well	wünschen	Gutes wünschen	jn etw. Gutes wünschen										
propitious	günstig	glückverheißend											
confidential	geheim	heimlich	vertraulich	verborgen	geheimhalten								
console (v.)	trösten	beruhigen	jm gut zureden										
luxuriant	üppig	prachtvoll	prunkvoll	luxuriös	(farbenprächtig)								
garlic	Knoblauch												
palm tree	Palme												
universe	alle Zeiten	Vergangenheit, Gegenwart und Zukunft	Zeit als Konzept										
axle	Achse	(Spindel)											
sleeve	Ärmel												
flute	Flöte												
female	weiblich	feminin											
groan	stöhnen	ächzen	seufzen										
smooth	reibungslos	ungehindert	fließend										
partnership	Gemeinschaft	Partnerschaft	sehr viel	zahlreich	eine Menge								
nest (n.)	Nest												
flora	Flora	Pflanzenwelt											
naked	nackt	unbekleidet	unverhüllt										
envelop	einwickeln	einhüllen	verbinden	umwickeln									
analyze	analysieren	spalten	trennen										
distinct	klar	deutlich											
celery	Sellerie												
discount (n.)	Rabatt	Preisnachlass											
philosopher	Weiser	weise	geistreich	Philosoph									
pass away	vergehen	verstreichen	verfließen	sterben	ableben	hinscheiden							
vow (n./v.)	schwören	Eid	Schwur										
elated	erfreulich	freudig	froh										
uncover	hochheben	hochziehen	enthüllen										
supplicate	beten	dringend bitten	ersuchen										
conscience-stricken	sich schämen	Scham	Schamgefühl										
towering	hochragend	aufragend											
take apart	auseinandernehmen	demontieren	aufmachen	auftrennen	anbrechen	abbauen	abreißen	abbrechen					
blow up	bersten	platzen	zerspringen	explodieren									
swindle	betrügen	täuschen	sich verstellen	vorgeben	simulieren								
wife	Ehefrau												
miserable	kühl	frostig	einsam	verlassen	traurig	elend							
perch (v.)	nisten	auf einem Baum nisten											
goblin	böser Geist	Dämon											
nimble	flink	geschickt	prompt	geschwind	agil	Sieg	Triumph						
wield	fassen	halten	festhalten	etw. in Händen haben	vorsitzen	den Vorsitz ausüben	leiten						
peel off	abstreifen	abschälen	abrinden										
collection	Kollektion	Sammlung	Ansammlung	sammeln									
double (adj.)	doppelt	zweifach	zweimal										
earn	verdienen	Geld verdienen	profitieren	Gewinn machen									
dislike (v.)	Verdacht	Groll	Hass	Feindschaft	nicht mögen	eine Abneigung hegen	verabscheuen	einer Sache überdrüssig sein					
unassuming	bescheiden												
apology	Gefühl des Bedauerns	sich beschämt fühlen	Missernte										
inexpensive	wohlfeil	billig	preiswert	ehrlich	redlich	unbestechlich							
sickle	Sichel												
drapes	Vorhang	Fenstervorhang	Gardine										
unshut (v.)	die Augen öffnen	aufschlagen											
struggle (v.)	sich abmühen	sich anstrengen											
Chinese zither	chinesische Zither	Zheng	zitherähnliches, vielsaitiges Instrument										
pool (n.)	Tümpel	Pool	Badebecken										
arrest (v.)	verhaften	festnehmen	reichen	erreichen									
bondservant	leibeigener Diener	Leibeigener	untergeordnet sein	angehören	unterstehen								
generous	großzügig	freigebig	leidenschaftlich	inbrünstig									
chaff	Spreu												
mess around	vorführen	zum Narren halten	spielen	jonglieren									
-proof	ertragen können	aushalten können	vertragen	-fest									
wheeze	schnaufen	außer Atem sein	schwer atmen	um Luft ringen	Asthma								
conjecture (v.)	schätzen	vermuten	mutmaßen										
messed up	Reisweintrester	faul	morsch	mürbe	in jämmerlichem Zustand	in völliger Unordnung	verpfuscht						
meet with	auf etw. stoßen	erleiden	durchmachen										
trough	Krippe	Futterkrippe	Trog	Viehtrog									
quiver (v.)	zittern	beben	schaudern										
mediocre	gewöhnlich	mittelmäßig	unbedeutend	geringwertig									
put to work	dingen	Diener											
fling (v.)	etw. hin und her schwingen	schwenken	schleudern										
rue (v.)	bedauern	Mitleid fühlen	hochschätzen	mit etw. sparsam umgehen	mit etw. schonend umgehen								
arrange	arrangieren	organisieren	einrichten										
forsake	wegwerfen	preisgeben	fallenlassen	aufgeben									
swallow (n.)	Schwalbe												
screen (v.)	bedecken	zudecken	verdecken	verschleiern	Schutz gegen etw. bieten	vor etw. schützen							
littoral (n.)	Feldrand	an der Seite	dicht an										
blend (v.)	mischen	mengen	vermengen	rühren									
betray	verraten	rebellieren	meutern										
voucher	Karte	Schein	Ticket										
rattan	Rattan	Peddigrohr											
state of affairs	Zustand	Form	Aussehen	Erscheinung									
wall	Wand	Mauer											
old cooking pot	antikes Kochgefäß	Dreifuß	Vierfuß										
get some shuteye	Schlafzimmer	Mausoleum	Grabzimmer	schlafen									
invade	einfallen	eindringen	eingreifen	herfallen									
immerse	einweichen	wässern	eintauchen	eintunken	tränken								
stolen goods	Diebesgut	gestohlenes Gut	Diebesbeute										
hide (v.)	verbergen	verstecken	weglegen	verdecken	verheimlichen								
guts	Eingeweide												
award (n.)	Prämie	Belohnung	Preis										
thick liquid	dicke Flüssigkeit												
oar	Ruder												
Jiang	Jiang												
abyss	tiefes Wasser	tiefer Teich											
solemn	ernsthaft	ernst	ehrerbietig	respektvoll	feierlich								
howl (v.)	pfeifen	heulen	brüllen										
desolate	verwüstet	trostlos	verlassen										
rust (n./v.)	Rost	rosten											
sesame	Sesam												
devalue	abwerten	entwerten											
nonspecific	auf dem Wasser treiben	treiben	überschwemmen	überfluten	allgemein	generell							
askew	schief	schräg											
rectify	korrigieren	berichtigen	richtigstellen	begradigen	gerademachen								
short of stature	klein	niedrig	untersetzt	stämmig									
sigh–ay-ay	Ach!												
fine dust	Staub	feiner Staub											
suffer	erleiden	ertragen	erdulden	ausstehen	aushalten	durchmachen	durchstehen						
cluster (n.)	Haufen	Traube	Bündel	Menge	Strauß								
thatch (n.)	Dachstroh	Stroh	Reet	Alang-Alang-Gras									
tangerine	Mandarine												
relax	strecken	erstrecken	entfalten	ausbreiten	gemächlich								
noble	großartig	prächtig	erweitern	verbreiten	popularisieren								
barbarian	Barbar	einebnen	abtragen	Ausländer	ausrotten	austilgen							
maternal aunt	Schwester der Mutter	Tante	Tante mütterlicherseits										
dividing line	Grenze	Grenze eines Landes	Grenze eines Gebietes										
stiff (adj.)	starr	steif	sich festfahren	auf einen toten Punkt anlangen	in eine Sackgasse geraten								
ginger	Ingwer												
porridge	Brei	dicker Brei											
bring to a boil	sieden												
caress (v.)	etw. sanft streichen	streicheln											
shave (v.)	rasieren												
snot	Rotz	Träne											
ladder	Leiter	Treppe											
decayed	verfault	morsch	verfallen										
employ (v.)	jn anstellen	anstellen	jn bitten, einen Posten zu übernehmen										
sacrifice (v.)	Opfertier	den Märtyrertod sterben	sein Leben hingeben	opfern									
elder sister	ältere Schwester												
lie down	liegen	sich hinlegen											
dodge (v.)	sich verbergen	sich verstecken	ausweichen	meiden	sich in acht nehmen vor								
stoop (v.)	sich biegen	sich nach vorn beugen	persönlich	selbst	eigen								
hanker	Sucht	Vorliebe	gierig										
flog	foltern	peinlich befragen											
summer heat	Hitze	sehr heißes Wetter	(Sommerhitze)										
behold	sehen	wahrnehmen											
gamble (v.)	Glücksspiel	wetten	um Geld spielen										
extravagant	luxuriös	verschwenderisch	überschwenglich	übertrieben	extravagant								
stop up	stopfen	verstopfen	versperren										
boil (v.)	kochen	Essen bereiten	Essen zubereiten										
various	verschieden	all											
put in storage	aufspeichern	lagern											
slaughter	schlachten	massakrieren	niedermetzeln										
add your John Hancock	unterschreiben	unterzeichnen	anordnen	Amt	Büro	in Vertretung handeln	vertreten						
yam	Kartoffel	Yamswurzel											
come back	heimkehren	zurückkehren	zurückgeben	wiedergeben	zusammenlaufen	zusammenkommen							
sift	sieben	durchsieben	Sieb	Wein erwärmen									
coffin	Sarg												
dad	Vater	Papa	Vati										
axe	Axt	Beil											
bite (v.)	beißen												
sly	raffiniert	listig	schlau	verschlagen									
prostrate oneself	auf dem Bauch liegen	sich auf den Bauch legen											
trample	treten	betreten											
tread on	stampfen	auf etw. herumtrampeln	mit Füßen treten										
hoof	Huf												
catch (v.)	festnehmen	fangen	etw. in der Hand halten	fassen	ergreifen								
step on	den Fuß auf etw. setzen	niedertrampeln	zertrampeln	mit dem Fuß auf etw. treten									
hop (v.)	springen	hüpfen											
slump (v.)	fallen	hinfallen	umfallen	stürzen	sinken	zurückgehen							
urge (v.)	kurz	eilig	dringend	drängen	fördern	antreiben							
kick (v.)	einen Fußtritt versetzen	mit dem Fuß stoßen	nach jm/etw. treten	treten									
impetuous	hitzig	aufbrausend	hitzköpfig	reizbar									
chirping (n.)	zirpen	laut zwitschern	zwitschern										
bath	baden	Bad											
algae	Alge												
exercise (n.)	drillen	üben	exerzieren	trainieren	Drill	Übung							
parched	trocken												
leap (v.)	springen	hüpfen											
jab (v.)	stechen	hineinstechen	stoßen										
show off (v.)	loben	rühmen	prahlen	scheinen	leuchten	blenden							
cunning	schlau	listig											
marrow	Knochenmark												
dirty	schmutzig	dreckig	beschmutzt										
whirlpool	Wirbel	Strudel	Vertiefung										
pot	Topf	Kochtopf	Kessel										
snail	Schnecke												
misfortune	Unglück	Unfall	Verhängnis	Katastrophe									
footpath	Feldweg	Rain	Feldrain										
rift (n.)	Spalt	Spalte	Riss	Ritze									
steep	steil	abschüssig											
barrier	Hindernis	Barriere											
accompany	begleiten	jm Gesellschaft leisten											
tunnel (n.)	Tunnel												
plunge (v.)	fallen	hinabstürzen	herabhängen	Gewicht									
undesirable	hässlich	garstig	abstoßend										
dig (v.)	graben	aushöhlen	ausbaggern										
kiln	Brennofen												
peep (v.)	lugen	heimlich blicken	heimlich beobachten	verstohlen blicken	spannen?								
den	Felsenhöhle	Höhle	Grotte	Versteck									
strait (adj.)	eng	schmal											
extract (v.)	auspressen	pressen											
poverty-stricken	in bedrängten Umständen	in Not	in Bedrängnis	verlegen	peinlich berührt								
poor	arm	armselig	dürftig										
hollow (n.)	Mulde	Hohlraum											
body cavity	Körperhohlraum	Körperöffnung											
tired	müde	erschöpft	ermattet										
spiral shell	Schneckenhaus	Schnecke	Fingerwirbel	Fingerabdruck									
yarn	Garn												
ample	reichlich	geräumig											
acquaint	fortsetzen	ein geistiges Erbe antreten	Traditionen übernehmen										
long-winded	Watte												
go around	aufrollen	spulen	winden	einen Umweg machen	umgehen	umkreisen							
bind (v.)	binden	zusammenschnüren											
continuous	kontinuierlich	sich erstrecken	sich hinziehen	Seidenwatte									
paint (v.)	malen	zeichnen	bildlich darstellen										
web	netzförmiges Gebilde	mit einem Netz umwickeln	mit einem Netz festhalten	netzförmiger Gegenstand									
silk fabric	Seidenstoff	Seidenwaren											
down (n.)	Flaum	Daune											
conclude	schließen	Vertrag abschließen	Freundschaft schließen										
purple	purpur	violett											
numerous	zahlreich	massenhaft	kompliziert	verwickelt	umständlich								
spin (v.)	spinnen												
cocoon	Kokon												
wind around	wickeln	winden	Wollfaden aufwickeln	jn in etw. verwickeln									
delicate	fein	sorgfältig											
fasten	zubinden	zuknöpfen											
let in	einlassen	aufnehmen											
disorderly	verwirrt	durcheinander	unordentlich										
shrink (v.)	schrumpfen	eingehen	sich zusammenziehen										
sum up	zusammensetzen	zusammenstellen	zusammenfassen										
gentry	Gentry	Landadel											
reason (n.)	Grund	Ursache	Anlass										
inception	Anfang	Beginn	Tat	Werk	Anfang einer Seidenfaser								
wring	wringen	auswringen											
unhurried	langsam	gemächlich	verzögern	verschieben									
warm (adj.)	warm	wärmen											
provide assistance	sich mit seinen Händen nach oben ziehen	unterstützen	helfen	jm Beistand leisten									
large rope	Tau	Strick											
vibrant	steif werden	hochkommen	emporkommend	lebensvoll	üppig	überschwänglich	lebhaft	lebendig					
head-hinge	Hals												
shell out	zahlen	bezahlen	entrichten	aushändigen									
request the presence of	einladen												
embroidery	sticken	Stickerei											
edible root	Kletterpflanze	Rübe											
gong	Gong												
make the rounds	patroullieren	auf Streife gehen											
bamboo basket	Bambuskorb	feinmaschiger Bambuskorb											
barbaric	grob	wild	roh	gewalttätig	barbarisch								
neck (n.)	Hals												
plant stem	Stängel	Stiel	Halm										
powerful	stark	kräftig	stämmig										
trail (n.)	Pfad	Fußweg											
creek	Bach	Flüsschen											
young	jung	minderjährig											
secluded	abgelegen	tief und dunkel	verborgen	heimlich	zurückgezogen								
wet	nass	feucht											
mysterious	schwerverständlich	tiefgründig	profund	schwarz	unglaubhaft	unglaubwürdig	mystisch	geheimnisvoll					
livestock	Haustier	Vieh											
save up	speichern	ansammeln	sein Haar wachsen lassen										
lead along	jn mit sich ziehen	an der Leine führen											
bowstring	Bogensehne	Sehne	Saite										
magnetism	Magnetismus	Porzellan											
nourish	wachsen	sich vermehren	vermehren										
kindhearted	barmherzig	mitleidig	gütig										
deride	auslachen	verlachen	verspotten	verhöhnen									
luminous	funkeln	leuchten											
modest	(von einem Kaiser) abdanken	abdanken	bescheiden										
unload	ausladen	entladen	demontieren	auseinandernehmen									
imperial	kutschieren	eine Kutsche lenken			JESSICA								
withstand	sich widersetzen	sich wehren	sich zur Wehr setzen	abwehren									
nest eggs	Ei	Laich	Eizelle	Nestei									
hatch (v.)	brüten	ausbrüten											
breast	Brust	Milch	gebähren										
float (v.)	an der Oberfläche schwimmen	auf der Oberfläche schwimmen											
captive	gefangennehmen	Gefangener	Kriegsgefangener										
minister	Minister	hoher Beamter											
trade (n.)	Handel												
pomegranate	Granatapfel												
doubt (v.)	zweifeln	verdächtigen	Argwohn	Zweifel									
obstruct	hindern	behindern	jn Steine in den Weg legen										
congeal	gerinnen	gefrieren	erstarren	fest werden									
simulate	nachahmen	imitieren	simulieren	kopieren	JESSICA								
exquisite	das Klingen aneinanderschlagender Jadestücke												
small bell	Klingel	Schelle											
actor	Opernsänger	Schauspieler											
mountain range	Bergkette												
bucket	Kübel	Eimer	Fass	Tonne									
read aloud	vortragen	vorlesen	etw. auswändig vortragen										
gush (v.)	quellen	sprudeln	strömen	hervorquellen									
eagerly	aufspringen	hüpfen											
exam paper	Buch	Band	Prüfungsbogen	Prüfungsaufgabe	Prüfungsarbeit								
circle (n.)	Kreis	Ring											
roll up	einrollen												
worn out	müde	ermüdet	angegriffen	matt	überdrüssig								
model	Prägestock	Gussform	Modell	Vorbild	Beispiel								
resentment	Hass	Feindseligkeit	Groll										
winding (adj.)	gewunden	gekrümmt											
wrist	Handgelenk												
tactful	taktvoll	höflich	zuvorkommend	verbindlich									
bowl	Schüssel	Schale											
deceitful	Arglist	Tücke	arglistig	tückisch	hinterhältig	betrügerisch							
kneel	knien	niederknien											
popular	öffentlich	die Öffentlichkeit vertretend	Fahrzeug mit Rädern	Wagen	Sänfte								
reward (n./v.)	eine Toast ausbringen	auf jn/etw. trinken	Belohnung	Vergütung									
pour wine	einschenken												
brutal	grausam	tyrannisch	unmenschlich	brutal									
mellow wine	edler Wein												
vinegar	Essig												
drunk	betrunken												
unmixed	pur	rein	Essenz										
emerald green	smaragdgrün	Eisvogel											
shattered	zerbrechen	zersplittern	bruchstückhaft	zerbröckelt	zerstückelt								
sour	sauer	Säure											
shuttle (n.)	Webschiffchen												
lofty	hoch	steil aufragend											
pretty	schön	hübsch											
quarrel (n.)	Streit	Zank	Hader										
thick sauce	Soße	Mus	Paste	Mark									
just like	wie	gleich	noch immer	(noch immer)									
found (v.)	gründen	etablieren	etw. zustande bringen										
squat (v.)	hocken												
tease (v.)	necken	hänseln	aufziehen										
(rhetorical question)	(rhetorische Frage)												
triumphant	siegreich	triumphierend											
perpendicular	vertikal	senkrecht	lotrecht										
commend	loben	preisen	vornehm	ausgezeichnet									
giggling	lachen	kichern	Kichern										
alliance	sich verbünden	sich alliieren	Bündnis										
Mencius	Mengzi	Menzius											
fierce	wild	heftig	ungestüm	kräftig									
flourishing	in voller Blüte stehen	gedeihen											
small cup	kleines Trinkgefäß												
small box	Schachtel												
master thief	Dieb	Räuber	stehlen	rauben	entwenden	Meisterdieb							
swing (v.)	schaukeln	hin und her schwingen	schwingen	sich schwingen									
calm (adj.)	Frieden	Ruhe	friedlich	ruhig									
replete	voll	erfüllt	gefüllt	Überschuss haben									
basin	Becken	Wanne	Topf										
trophy	Pokal												
amass	enthalten	umfassen	in sich bergen	in sich schließen	speichern								
indiscriminate	übermäßig	übertrieben	ausschweifend	überschwemmen	überfluten	überfließen	überlaufen						
probe (v.)	Messing- oder Bronzespiegel	spiegeln	sich widerspiegeln	einer genauen Prüfung unterziehen	genau untersuchen								
abashed	Verlegenheit	verlegen											
embarrassed	peinlich												
toss (v.)	werfen	schleudern	zu Schleuderpreisen verkaufen	wegwerfen									
indulge in	verzögern	verschieben	für etw. schwärmen	schwärmen									
pillow	Kopfkissen												
view (v.)	anschauen	ansehen	besichtigen	überblicken									
take on	etw. an sich ziehen	übernehmen	heranziehen	alles an sich reißen	etw. an sich reißen	jn in die Arme nehmen	befestigen						
cable (n.)	Tau	Seil	Kabel	Trosse	Schiffstau								
ruthless	grausam	brutal	unbarmherzig	sich überwinden	sich ein Herz fassen	energisch	entschlossen						
hate (v.)	hassen	Hass											
upper crust	Adelswürde	Adelstitel	Adelsrang										
chew (v.)	kauen	zerkauen											
wholeheartedly	aufrichtig	ehrlich	offen	ernstlich									
reclaim	urbar machen	kultivieren											
leopard	Leopard	Panther											
cat	Katze												
mien	Gesichtszüge	Miene	Aussehen	Erscheinung									
lucent	hell	klar	laut und deutlich										
wolf	Wolf												
starving	hungrig sein	Hunger haben	Hungersnot	Hunger									
spare (v.)	begnadigen	jm etw. nachsehen	jm etw. verzeihen	reich	viel	voll							
ornaments	Schmuck	Ornament	Zierart										
beverage	Getränk												
eat away	beschädigen	anfressen	zerfressen										
sated	satt	gesättigt											
bread	Dampfbrötchen												
cookie	runder flacher Kuchen	Fladen	Keks										
dumpling	Jiaozi												
hungry	hungrig												
submerge	untertauchen	eintauchen	verstecken	insgeheim	heimlich								
silkworm	Seidenraupe												
irrigate	bewässern												
incensed	entrüstet	empört	tief gerührt	tief bewegt	großzügig	großmütig							
duckweed	Entengrütze												
scale (n.)	Waage												
confuse	durcheinanderbringen	vermischen											
Chinese mugwort	Beifuß	Wermut											
Good grief!	Oh mein Gott!	Ah	Oje	Ach, du meine Güte!	Meine Güte!								
pull out	ziehen	ausziehen	ausreißen										
climb (v.)	klettern	klimmen											
stockpile (v.)	einlagern	speichern	auf Halde legen	auf Vorrat anlegen	stationieren	einquartieren							
pause (n./v.)	Pause												
ton	Tonne												
unadulterated	rein	lauter	unvermischt	makellos									
fall due	fällig werden	ablaufen	verstreichen										
teeth	Zahn	Zähne	Zähne?										
shows	Schauen	Schau	Show	Shows									
length of service	Alter	Lebensjahr	Dauer	Dienstjahr									
turbulent	reißend	tosend	aufwallend	stürmisch	turbulent								
fence	Zaun	Hecke											
crime	Schuld	Sünde											
butcher (v.)	schlachten												
differentiate	unterscheiden	etw. von etw. trennen											
braid (n.)	Zopf												
arm (n.)	Arm	Oberarm											
split (v.)	spalten	hauen	hacken	einschlagen	(Blitz) einschlagen								
analogy	Beispiel	Vergleich	Metapher										
out-of-the-way	entlegen	abgelegen	abseits	exzentrisch									
translate	übersetzen												
select (v.)	auswählen	wählen	aussuchen										
swamp (n.)	Gebiet mit großer Wasseransammlung	Sumpf	Moor										
pad (n./v.)	Polster	Kissen	Wulst	Bausch	etw. unter etw. legen								
earnest	aufrichtig	ehrlich	echt	herzlich									
entangle	sich verwickeln	sich verstricken	zusammenrotten	zusammentrommeln									
bully (v.)	beleidigen	schikanieren	Eisscholle										
water caltrop	Wassernuss												
mausoleum	große Grabanlage	Mausoleum											
cough (v.)	husten												
brake (v.)	bremsen												
cry out	schreien	laut rufen											
brew (v.)	brauen	brennen	gären lassen										
stronghold	strategisch wichtige Punkte an einer Grenze	Grenzfestung	Grenzfeste										
stockade	Lattenzaun	Palisade	Pfahlwerk										
constitution	Konstitution	Verfassung	Gesetz	Verordnung									
sunny	heiter	sonnig											
guess	raten												
pacify	befrieden	den Frieden bringen											
debt	Schulden												
remains	Überbleibsel	Überrest	Ruine	Spur	Fährte	Anzeichen							
domestic animal	Haustier												
impressive	wohlhabend	blühend	üppig	reichlich	groß	erhaben	feierlich	sich wölben					
fishy smell	nach Fisch riechen	rohes Fleisch oder roher Fisch											
orangutan	Orang-Utan												
awaken	aufwachen	erwachen											
visionless	blind	blindlings	vergeblich										
administer	Lünse	Achsnagel	regieren	verwalten	administrieren								
contract (n.)	gravieren	eingravieren	Kontrakt	Vertrag									
adore	beten	Ehrerbietung bezeigen	sich vor jn. niederwerfen										
spotless	rein	sauber	klar	makellos	fleckenlos								
bee	Biene	Wespe											
peak (n.)	Gipfel	Spitze											
cutting edge	Schneide	Klinge											
chance upon	treffen	sich begegnen	auf etw/jn. stoßen										
disheveled	zerzaust	locker	lockig	wirr									
sew	nähen												
play an instrument	vortragen	ein Musikstück vortragen	auf einem Instrument spielen										
gather together	sammeln	zusammentun	zusammenbringen										
Qin	Qin												
foolish	dumm	stupide	stupid	einfältig	ungeschickt	schwerfällig	unbeholfen						
carry in both hands	etw. mit beiden Händen tragen	mit beiden Händen tragen											
sigh (v.)	seufzen												
arduous	hart	schwierig											
beach (n.)	Strand	Untiefe	Sandbank										
complete (v.)	beenden	beendigen	abschließen	vollenden	völlig	vollständig	ganz	sämtlich					
saliva	Speichel	Spucke											
recite	rezitieren	aufsagen	Gedichte aufsagen										
greedy	korrupt	bestechlich	gierig	unersättlich									
stringed instrument	Saiteninstrumente												
chestnut	Kastanie	Esskastanie	Marone										
deep pool	tiefer Teich	Grube	Mulde										
resituate	umziehen	seinen Wohnsitz wechseln	umsiedeln	seinen Wohnsitz verlegen	versetzen	sich wandeln	sich verändern						
overturn	umstürzen	umkippen	umwerfen	bedecken	überdecken								
flutter (v.)	flattern	hin und her wehen											
boss (n.)	Chef	Boss											
broad	breit	weit	geräumig	reich	wohlhabend	begütert							
close (v.)	schließen	verschließen	zumachen										
moisten	befeuchten	schmieren	etw. gleitfähiger machen	geschmeidig	feucht	glatt							
cabinet	Kabinett	Regierungskabinett	Mädchenzimmer	Pavillon									
put aside	legen	stellen	setzen	beiseitelegen	beiseiteschieben	aufschieben							
explicate	erklären	erläutern											
peruse	lesen	durchlesen	durchgehen										
stuffy	schwül	drückend	stickig										
flash (v.)	aufblitzen	Blitz											
valve	Ventil	Klappe											
floodgate	Schleuse	Wasser aufstauen	Bremse										
repudiate	widerlegen	zurückweisen	ablehnen										
ash-colored	grau	ergraut	aschfahl	himmelblau	azurblau	dunkelgrün							
rob	rauben	plündern	entreißen										
humble (adj.)	dürftig	gering	schlecht	bescheiden									
lifetime	Lebenszeit												
sad	Trauer	Kummer	Mitleid	Erbarmen									
irresolute	zögern	unentschlossen	zaudern	wanken	auf und ab gehen	hin und her gehen							
annihilate	vernichten	ausrotten											
bamboo slip	Los	Bambusstreifen	Bambusstreifen als Los										
fiber	Faser	sehr dünn	fein										
gullet	Kehle	Schlund											
monkey	Affe												
Korea	Korea												
disobey	zuwiderhandeln	sich widersetzen	gegen etw. verstoßen										
latitude	Einschlagfaden	Einschussfaden	Schussfaden	geografische Breite									
pole	Stange	Stab	Stock	Gerte	Rute								
rarely	selten	rar											
veranda	Veranda	Gartenhäuschen											
liver	Leber												
publication	drucken	herausgeben	veröffentlichen	Zeitschrift	Magazin								
sweat (n.)	Schweiß												
shaft	Schaft	Stange	Arm eines Geräts										
bold	tapfer	unerschrocken											
slowly	langsam	gemächlich	sanft										
recount (v.)	erzählen	berichten	darstellen										
smear (v.)	beschmieren	bestreichen											
slanting	schief	schräg	geneigt										
flared horn	Lama (Buddhismus)	Lautsprecher	Suona (chin. Blasinstrument)	Holzrohrtrompete									
hack (v.)	husten	krampfhaft husten	bellen	laut husten									
rely on	sich auf etw./jn stützen	sich auf jn/etw. verlassen	auf jn/etw. angewiesen sein	sich nicht vom Fleck rühren	hartnäckig stehenbleiben	abstreiten	leugnen	ableugnen					
lazy	faul	träge	arbeitsunlustig										
tender (adj.)	zart	weich	hell	unerfahren	jung	grün hinter den Ohren							
refine	schmelzen	raffinieren	läutern	kondensieren	härten	stählen	vergüten						
chain (n.)	Kette												
swollen	anschwellen	Schwellung	geschwollen										
director	Vorstandsmitglied	leiten	überwachen	beaufsichtigen									
draw together	konzentriert	(seine Gefühle, Zuneigung usw.) auf etw. konzentrieren	Becher	Schälchen	Kelch								
phlegm	Auswurf	Sputum											
disease	Krankheit												
hurt (v.)	weh tun	schmerzen											
get well	genesen	geheilt											
epidemic	Seuche	Pestilenz	Epidemie										
cancer	Krebs	Krebsgeschwulst	Karzinom										
fatigued	müde	erschöpft	ermattet										
rapid	Leiden	Schmerz	Not	schnell	mit hoher Geschwindigkeit								
idiotic	töricht	blödsinnig	idiotisch										
tumor	Geschwulst	Tumor											
trace (n.)	Narbe	Spur											
itch (v.)	jucken	Jucken	kitzeln										
paralysis	Lähmung	Paralyse											
sore (n.)	Geschwür	Hautgeschwür	Hautentzündung	Verletzung	Hautverletzung	Entzündung							
stable (adj.)	stabil	fest	sicher										
hidden	versteckt	verborgen	latent	etw. verborgen halten									
addiction	Sucht												
gigantic	gigantisch	groß	riesig	enorm									
canal	Kanal	Graben											
refuse (v.)	ablehnen	weigern	verweigern	zurückweisen	abschlagen								
square (n.)	Tischlerwinkel	Anschlagwinkel											
distance	Entfernung	Distanz	Abstand										
rectangular frame	Rahmen	Einfassung	Umrandung	rechteckiger Rahmen									
rectangular basket	Korb	Körbchen	rechteckiger Korb										
smash (v.)	stampfen	schlagen	hämmern	stoßen	zerbrechen	zerschlagen							
converge	zusammenfließen	zusammenlaufen											
artisan	Handwerker												
bandit	Bandit	Räuber											
keep out of sight	verbergen	verstecken	geheimhalten										
pocket	Tasche	Tüte	einpacken	einwickeln									
vomit (v.)	sich erbrechen	sich übergeben											
hit (v.)	schlagen	prügeln											
human body	menschlicher Körper	Körper											
hold one‘s head high	den Kopf heben												
curb (v.)	zügeln	niederhalten	im Zaum halten										
large-flowered plants	bestimmte krautige Pflanzen mit großen Blüten	Pflanzen mit großen Blüten	(Sonnenblume)										
coworker	Amtskollege	Kollege	Beamter										
far away	fern	weit											
comprehend	verstehen	erkennen	überblicken	überschauen	von einer Höhe aus in die Ferne sehen								
cure (v.)	heilen	jn ärztlich behandeln	jn ärztlich versorgen										
glare (v.)	die Augen aufreißen	die Augen weit aufmachen	auf etw. starren	starren	jm einen ärgerlichen Blick zuwerfen	anstarren							
bench	Bank	Hocker											
transparent	durchsichtig	klar	hell										
splash (v.)	mit Wasser bespritzen	besprengen	ausschütten										
allocate	zuteilen	zuweisen	bereitstellen	(mit der Hand, dem Fuß, einem Stock usw.) rühren	rühren	rücken	drehen	bewegen					
fir tree	Tanne												
well-mannered	höflich	vornehm	vornehm und liebenswürdig	liebenswürdig	zuvorkommend								
shirt	Hemd	ungefüttertes Gewand											
manifest (adj.)	klar	deutlich	 offensichtlich	manifest									
puffy	anschwellen	geschwollen	sich ausdehnen	sich vergrößern	aufgebläht	aufgedunsen	voluminös						
take advantage of	nutzen	ausnutzen	etw. zum Anlass nehmen	die Gunst der Stunde nutzen	eine Gelegenheit ergreifen	(Anlass, Gelegenheit, Zeit) nutzen							
diagnose	ärztliche Untersuchung	(einen Patienten) untersuchen											
seep	durchsickern	sickern											
gum	Gummi	Leim	leimen										
wrong (adj.)	absurd	widersinnig	falsch	unsinnig									
deserted	still	leer	verlassen	wenig	spärlich								
speck	Fleck	Klecks	Sprenkel	Tupfen									
design (n.)	dekoratives Muster	Verzierung	Falte										
small shovel	Schaufel	Schippe											
Samoa	Samoa												
backbone	 Rückgrat	Wirbelsäule											
letter	Brief	Kästchen	Behälter	Schutzhülle									
culvert	Durchlass	überwölbter Abflusskanal	Dole										
reflect	spiegeln	widerspiegeln	scheinen										
calamity	Unheil	Verhängnis											
plump	fett	mollig	prall										
crawl (v.)	kriechen	hinaufklettern	emporklimmen										
scar (n.)	Narbe	Makel	Fehler										
gorgeous	farbenprächtig	prächtig	wunderschön	knallbunt	grell	amourös	Liebes-						
sugary	süß	honigsüß											
pliers	Zange												
matchmaker	Ehevermittler	Ehestifter	Kupplerin										
coal	Kohle												
scheme (v.)	planen	beraten	Idee	Geistesblitz	Einfall	Plan	Strategem	Vorhaben	List				
chess	Schach	Brettspiel											
dupe (v.)	betrügen	täuschen	hinters Licht führen	schikanieren	bedrängen	tyrannisieren							
flag (n.)	Fahne	Flagge	Banner										
hoarse	wiehern	heiser											
rip (v.)	aufreißen	zerreißen	abreißen										
tolerate	standhalten können	ertragen	aushalten	können	dürfen								
survey (v.)	einen Text mit dem Original vergleichen	kollationieren	untersuchen	nachforschen	(lesen und korrigieren)								
dispatch (v.)	senden	schicken	vertreiben	verjagen									
censure (v.)	verurteilen	anprangern	brandmarken	jm Vorwürfe machen									
sack (n.)	Tasche	Beutel	Kapsel										
burst (v.)	brechen	(Damm, Deich) brechen	durchbrechen										
cupboard	Schrank	Truhe											
fitting (adj.)	passend	geeignet											
friendship	Freundschaft												
rent (n./v.)	mieten	pachten	Miete	Mietzins									
coarse	grob	grobkörnig	rauh	dick	vulgär	roh							
block (v.)	hindern	verhindern	aufhalten	blockieren									
heap (v.)	aufeinanderschichten	auftürmen	aufhäufen										
baseball base	mauern	aufschichten	Wallanlage	Schutzwall	Festungswall	Base (Baseball)							
hoe (n./v.)	Hacke	hacken											
thicket	Gebüsch	Gesträuch											
plain (adj.)	einfach	schlicht											
pounce on	sich auf etw./jn stürzen	sich auf etw./jn werfen											
servant	Diener	Dienstpersonal											
musical score	Musiknoten	Noten zu einem Musikstück	Partitur (nur mehrstimmig)										
fool (v.)	betrügen	täuschen	übertölpeln	jn um etw. prellen									
deluge	Hochwasser	Flut											
warm by a fire	etw. am Feuer trocknen	etw. am Feuer wärmen											
respectful	respektvoll	voller Respekt	ehrerbietig	ehrfurchtsvoll									
arch (n./v.)	die Hände in Brusthöhe gewölbt aufeinanderlegen	gewölbt	sich krümmen	überwölbt	sich biegen	sich verbiegen							
violent	stürmisch	ungestüm	grausam	brutal	jähzornig	cholerisch	jäh	hitzköpfig					
waterfall	Wasserfall												
explode	platzen	bersten	explodieren										
ceremonial hall	Tempelhalle	Palasthalle											
have on	aufhaben	anhaben	tragen	aufsetzen	anziehen								
wings	Flügel	Flanke											
dung	Dung	Kot	Exkremente	Ausscheidungen	Mist								
compose	verfassen	schreiben											
mute (adj.)	stumm	heiser											
kettle	Kanne	Kessel											
crab (n.)	Krabbe												
lax	schlaff	locker											
purchase (v.)	anschaffen	ankaufen	kaufen										
ditch (n.)	Graben	Schützengraben	Kanal										
key	Schlüssel												
plead	appellieren	aufrufen	Appell	Aufruf									
Vol.	Heft	Buch	Band	Exemplar	(Band und Exemplar: ZEW)								
delete	streichen	weglassen											
palisade	Gitter	Gatter	Zaun										
coral	Korallen												
everywhere	überall	über und über											
partial	parteiisch	voreingenommen	tendenziös	sich nach einer Seite neigen									
sink (v.)	versinken	untergehen											
human relationships	menschliche Beziehungen	zwischenmenschliche Verpflichtungen											
resist	stützen	Halt geben	widerstehen	abwehren	entschädigen	Ersatz leisten	büßen						
hoodlum	Rowdy	Gauner	Lump	Schurke	Halunke								
breastfeed	stillen	die Brust geben											
shop (n.)	Laden	Geschäft											
supplement (v.)	helfen	beistehen	assistieren	unterstützen	ergänzen								
capture	fangen	verhaften	festnehmen										
apply	aufstreichen	auftragen	einschmieren	(Salbe, Pulver) aufstreichen									
river mouth	Flussmündung	Flussufer											
cattail	Rohrkolben	Katzenschwanz											
slight (adj.)	dünn	klein	leicht	gering	kleinlich	knauserig	nicht freigebig						
register (n.)	Heft	Buch	Rechnungsbuch	Verzeichnis									
mentor	Meister	Lehrer	lehren	unterrichten									
bind fast	binden	festbinden	fesseln										
outer walls	äußerer Wall einer Stadt												
limitless	weit	geräumig	ausgedehnt	Umriss	Kontur	Außenlinie							
despicable	verachten	geringschätzen	gemein	niederträchtig	vulgär								
Jerusalem	Jerusalem	Jesus											
grandfather	Großvater												
outskirts	Vorort	Vorstadt	Peripherie	Peripherie der Stadt									
nation	Staat	Land											
truss (v.)	jm die Hände auf dem Rücken zusammenbinden	binden	festbinden	wickeln									
post (v.)	etw. mit der Post schicken	etw. mit der Post senden	schicken	senden	postalisch								
Deng	Deng												
hurl	werfen	schleudern											
hallway	Korridor	Wandelgang	Säulengang										
hug (v.)	umfassen	umarmen	umgeben	sich drängeln									
satin	Satin	Atlasgewebe	Atlas										
wily	schlau	listig	verschlagen	trickreich	durchtrieben								
hold in the mouth	etw. zwischen den Lippen halten	etw. mit den Zähnen halten											
ardent	leidenschaftlich	heftig	heiß										
longevity	langes Leben												
large waves	große Welle	Woge	Brandung										
cast (v.)	Metall gießen	gießen											
pray	beten												
make arrangements	Spielmarke	Jeton	vorbereiten	planen	Vorbereitungen treffen								
attend to	bedienen	aufwarten	jm aufwarten										
rear (v.)	füttern	Futter geben											
liner	Ozeandampfer												
navigate	steuern	navigieren	segeln	schiffen	fliegen								
light boat	leichtes Boot												
warship	Kriegsschiff												
ship‘s cabin	Kabine eines Schiffs oder Flugzeugs	Schiffskabine	Kabine	gesamter Innenraum eines Schiffs oder Flugzeugs									
along (prep.)	entlang	längs	an ... entlang										
lead (n.)	Blei												
fox	Fuchs												
petal	Blütenblatt												
brim over	überlaufen	überfluten	überfließen	übermäßig	übertrieben								
spare time	Muße	freie Zeit											
red sky	von der Sonne gefärbte Wolken	Morgenrot	Abendrot	Morgen- oder Abendrot									
oxygen	Sauerstoff												
atmosphere	Atmosphäre	Stimmung	(Bedeutung?)										
chlorine	Chlor												
hydrogen	Wasserstoff												
strengthen	festigen	konsolidieren											
tyrant	Tyrann	Despot	Führer des Bundes der Herzöge im alten China	Hegemon									
dam (n.)	Staudamm	Sperrmauer	Talsperre	Damm	Deich	Schutzdamm gegen Hochwasser							
tighten	straffziehen	zuschnüren	festbinden	zubinden									
bow respectfully	Fellball	ernähren	großziehen	sich beugen	sich verbeugen								
boots	Stiefel												
whip (n./v.)	Peitsche	peitschen											
sprout (n.)	Spross	Schössling											
surprised	erstaunt sein	überrascht sein	sich wundern										
prop up	stützen	abstützen	unterstützen										
polished	normgerecht	ordentlich	korrekt	vornehm	nett	elegant							
wicked	unrecht	übel	unsauber	ketzerisch	Krankheit verursachende Umwelteinflüsse								
of great depth	von tiefer Bedeutung	abstrus	schwerverständlich	geheimnisvoll	mysteriös								
deep inlet	Bucht mit Ankerplatz	tiefe Bucht											
remorseful	bereuen	bedauern	ärgerlich	verärgert	verdrossen								
be informed	all	ganz	wissen	erfahren									
pilfer	stehlen	verstohlen	heimlich										
painstaking	ausführlich	eingehend	etw. genau überprüfen										
auntie	Tante	Ehefrau eines jüngeren Bruders des Vaters											
blanket (n.)	Bettdecke												
milli-	feines Härchen	Pinsel	Milli-										
consume	verbrauchen	kosten											
till (v.)	das Land bebauen	bewirtschaften	ackern	pflügen									
records	Buch	Werk	Eintragung	Register									
excuse (n.)	Ausrede												
hold up	etw. auf der flachen Hand tragen												
be afraid of	fürchten	scheuen											
Hello…	Hallo												
bloated	sich ausdehnen	anschwellen	aufgeschwollen sein	Schwellung	Völlegefühl	Blähung							
tent	Schutzdach mit Vorhängen	Vorhang	Zelt	Moskitonetz									
IV	IV												
beard	Bart												
loose	locker	lose	wackelig	lockern									
roc	Roch												
twitter (v.)	zwitschern												
swan	Schwanengans	Schwan											
pigeon	Taube												
crane	Kranich												
oriole	Pirol												
magpie	Elster												
gull	Möwe												
raven	Rabe												
goose	Gans												
crow	Krähe												
zoom-zoom	tuten	heulen	pfeifen										
pound with a pestle	mörsern	etw. in einem Mörser zerreiben	etw. in einem Mörser zerstoßen										
residence	Wohnsitz	Wohnort	Wohnung										
pea-brained	dumm	töricht	jn an der Nase herumführen	jn zum Narren halten									
by chance	zufällig	unerwartet	gelegentlich	Figur	Bildnis								
stern	streng	strikt	rigoros	unnachsichtig									
encourage	ermuntern	anspornen	aneifern										
steel	Stahl												
hillock	kleiner Hügel	Hügelchen	Anhöhe	Bodenerhebung									
guidelines	Hauptleine (eines Netzes)	Hauptkettenglied	Programm	Klasse									
go against	widerstreben	entgegen	zuwider	entgegengesetzt	jm Widerstand entgegensetzen								
go upstream	gegen den Strom	stromaufwärts	sich etw. ins Gedächtnis zurückrufen	zurückdenken									
plastic (n.)	formen	modellieren	Plastik	Kunststoff									
vat	Tongefäß	irdener Topf	großer Behälter										
jar	Büchse	Dose	Topf	Krug									
depressed	trübsinnig	schwermütig	bedrückt	deprimiert	üppig	gedeihend							
salt (n.)	Salz												
salty	salzig	gesalzen											
draw out	herausholen	herausnehmen	herausziehen										
wash in a container	etw. in einem Korb oder in einer Pfanne waschen												
pottery	Keramik	Tonwaren											
rumor	Ballade	Lied	Gerücht										
injustice	Unrecht	Ungerechtigkeit	Justizirrtum										
gluttonous	unersättlich	gefräßig	schleckerig	naschhaft									
tow (v.)	ziehen												
strive	sich bemühen	sich Mühe geben	sich anstrengen										
rubber tree	Kautschukbaum												
pleased	erfreut	freudig	Bequemlichkeit										
take flight	galoppieren	emporschnellen	in die Höhe steigen	emporsteigen									
numeral	Nummernbezeichnung	Ziffernbezeichnung	Gewichtsbezeichnung										
tame (adj./v.)	zahm	zähmen	bändigen	dressieren									
Mary	Marie												
be stationed	sich aufhalten	bleiben	verweilen	verbleiben	stationieren	Standort halten							
arrogant	Hochmut	Überheblichkeit	Arroganz	Dünkelhaftigkeit									
gallop (v.)	schnell fahren	galoppieren											
leech-hopper	Blutegel	Grashüpfer	Ameise	Bluthüpfer	Grasegel	Egelhüpfer							
proof	sich anlehnen	sich auf etw. verlassen	Beweis	gemäß	entsprechend								
maneuver (v.)	fahren	schnell fahren	rasen										
disturb	Aufruhr	Unruhe	liederlich	wollüstig	kokett								
drive (v.)	vorspannen	anspannen	fahren	lenken	steuern								
mule	Maultier	Maulesel											
refute	bestreiten	zurückweisen	widerlegen	widersprechen	Leichter	Lastkahn	mit einem Lastkahn transportieren						
rush (v.)	sich stürzen	stürmen	sich durchschlagen	sich durchkämpfen	sich durchs Leben schlagen								
drive away	vertreiben	zerstreuen	ein Pferd lenken	einen Wagen lenken	rasen	schnell rennen							
cheat (v.)	betrügen	prellen	lügen	begaunern	beschwindeln								
trot (v.)	traben												
hand over	überreichen	übergeben	aushändigen	der Reihe nach	nacheinander								
take captive	Kriegsgefangener	gefangennehmen											
despotic	grausam	tyrannisch	unmenschlich	brutal	misshandeln								
skin (n.)	Haut												
Louvre	Louvre												
stove	Ofen	Herd											
reeds	Schilf												
donkey	Esel												
loss	Verluste haben	Verluste erleiden	verlieren	Geld verlieren									
filthy	Schmutz	Dreck	schmutzig	dreckig	verunreinigen	beschmutzen							
stunned	verblüfft	erstaunt	bestürzt	in Staunen versetzt									
brag	übertreiben	aufbauschen	sich übertrieben ausdrücken	"preisen	"	loben								
collapse (v.)	zusammenbrechen	einstürzen	zu Fall kommen										
straddle (v.)	schreiten	ausschreiten	mit gespreizten Beinen dastehen	rittlings sitzen									
donate	darbringen	darbieten	überreichen	widmen	etw. zur Schau tragen								
melt	auftauen	schmelzen											
separate (v.)	trennen	aufteilen	dazwischenliegen										
filter (v.)	filtern	seihen											
celebrate	feiern	gratulieren											
recommend	empfehlen	Gras	Stroh	Strohmatte									
outstanding	außerordentlicher Mensch	außergewöhnlicher Mensch	Held	Heros	überragend	außergewöhnlich	hervorragend						
instant	Augenblick												
Chinese unicorn	chinesisches Einhorn	Qilin											
pity (v.)	Mitleid haben	bemitleiden	sich erbarmen										
neighbor	Nachbar												
bask	von der Sonne bescheinen lassen	sonnen											
spill (v.)	spritzen	bespritzen	sprengen	besprengen	verspritzen	verschütten							
cease	eine Tätigkeit einstellen	mit etw. aufhören	aufhören										
put in order	Pendel	schwenken	hin und her bewegen	stellen	setzen	legen							
lips	Lippe												
disgrace (n./v.)	Schmach	Schande											
quake (v.)	beben	erschüttern	vibrieren										
vibrate	flattern	schütteln	rütteln	schwingen	sich regen	sich aufraffen	anregen						
vigor	Seele	Energie	Geist	(Vitalität)	Vitalität								
scholar tree	Schnurbaum	Pagodenbaum											
enchant	Teufel	Dämon	böser Geist	verzaubernd	charismatisch	unwiderstehlich							
marvelous	wertvolle Rarität	selten und kostbar	rar	wunderschön	feine Jade								
soul	Seele	Stimmung	Geist	edler Geist einer Nation									
ashamed	beschämt	reuevoll	von Gewissensbissen gepeinigt werden	ein schlechtes Gewissen haben									
leader	Vorgesetzter	Chef	Anführer										
ugly	hässlich	scheußlich	garstig	unansehnlich	abscheulich								
raised path between fields	Erddamm auf dem Feld	erhöhter Ackerstreifen	Rain	Feldrain	kleiner erhöhter Weg zwischen zwei Feldern								
dote on	verwöhnen	jn seine Gunst schenken	bevorzugen										
huge	riesig	gewaltig	kolossal	unzählbar und chaotisch									
draw near	sich nähern	eintreffen	zusammenrechnen	kämmen									
deaf	taub												
cage (n.)	Käfig	Behälter aus Bambus	Korb	Dampfgerät	Topfaufsatz zum Dämpfen								
insert (v.)	stecken	hineinstecken	aufstecken	einsetzen									
ruin (v.)	zerstören	vernichten	verbrennen	verleumden	diffamieren								
mother‘s brother	Onkel mütterlicherseits	Bruder der Mutter	Schwager										
stake (n.)	Pfahl	Stange											
bore a hole	meißeln	stemmen	Meißel	Stechbeitel									
mouse	Maus	Ratte											
scurry	auf und davon laufen	in Panik davonstürzen	fliehen	ausreißen									
dried meat	Opfermonat	12. Monat des Mondjahres	Eingepökeltes	Eingesalztes									
wax (n.)	Wachs	Kerze											
hunt (v.)	jagen												
vessels	Wasserfahrzeug	Wasserfahrzeuge											
elder brother‘s wife	Frau des älteren Bruders	Schwägerin											
emaciated	dünn	mager	abgezehrt	abgemagert									
search (v.)	durchsuchen	auf der Suche nach etw. sein											
unhulled rice	Reis	ungeschälter Reis	Naturreis										
tread (v.)	betreten	schreiten	stampfen	springen	hüpfen								
surging	überfließen	fluten											
get stuck	Fallgrube	Falle	hineinfallen	steckenbleiben	in etw. geraten								
flame (n.)	Flamme	Feuerzunge											
filling	Füllung	Füllung für Kuchen u.ä.											
vehicles	Fahrzeug	Fahrzeuge											
dissemble	verheimlichen	verschweigen	für sich behalten										
frank (adj.)	klar	heiter	frisch	offenherzig	gerade	sich wohl fühlen							
embellish	schmücken	dekorieren	zusammenflicken	zusammennähen	ausschmücken								
bump (v.)	berühren	stoßen	treffen	begegnen	auf jn stoßen								
transfer (v.)	verrücken	verlegen	rücken	verschieben									
charge falsely	verleumden	verleumderisch beschuldigen	anschwärzen	bezichtigen									
reputation	Ruhm	Ruf											
islet	kleine Insel	Inselchen											
thick-headed	dumm	wirrköpfig	doof	töricht	stur	starrsinnig	schwerfällig						
brick	Ziegel	Ziegelstein											
favor (n.)	Gunst	Wohltat	Vergünstigung	(Gefallen)	Gefallen								
ear of grain	Ähre												
expansive	weit	ausgedehnt	geräumig	frei von Sorgen und Ängsten									
mine (n.)	Zeche	Bergwerk	Erz										
enlarge	ausdehnen	erweitern	verbreitern	vergrößern									
smart	Hörvermögen	ein feines Gehör	hellhörig	klug	gescheit	intelligent							
onion													
gall bladder													
look upward													
cuddle													
time and again													
turbid													
candle													
touch (v.)													
admonish													
railing													
impede													
tracks													
shrug (v.)													
pharmaceutical (n.)													
abstain from food													
squeeze (v.)													
push button (n.)													
shy													
New York													
spleen													
beer													
stele													
illustrious													
terrify													
radiating vitality													
indication													
phraseology													
tortoise													
rope (n.)													
flies													
butterfly (front end)													
butterfly (back end)													
spider (front end)													
spider (back end)													
camel (front end)													
camel (back end)													
dragonfly (front end)													
dragonfly (back end)													
male phoenix													
female phoenix													
olive (A)													
olive (B)													
glass (front side)													
glass (back side)													
coffee (first drop)													
coffee (last drop)													
grapes (A)													
grapes (B)													
in-													
-struct													
ping													
pong													
Cui													
Cao													
Liu													
Pan													
Liang													
Shen													
Zheng													
Tam													
Zhao													
Yao-2													
Lu													
Jiang-2													
Fan													
Xue													
Tu													
Peng													
Yu-2													
Feng													
Wei													
Yue													
as though													
jasmine													
Hunan Province													
outlying areas													
dark blue													
reverent													
na													
fine jade													
gem													
30 catties													
Oh!													
cannon													
search for													
hibiscus													
cottonrose hibiscus													
tricks of the trade											訣	-	
titanium	Titan										鈦	-	
hemorrhoids	Hämorrhoiden												
													
													
													
													
													
													
													
													
													
													
													
													
													
													
													
													
													
													
													
													
													
													
													
													
													
													
													
													
													
													
													
													
													
													
													
													
													
													
													
													
													
													
													
													
													
													
													
													
													
													
													
													
													
													
													
													
Biang													
